date,visitor_name,visitor_pts,home_name,home_pts,overtime,home_win,margin_of_victory,year,postseason
2023-10-24,Los Angeles Lakers,107,Denver Nuggets,119,0,True,12,2024,False
2023-10-24,Phoenix Suns,108,Golden State Warriors,104,0,False,4,2024,False
2023-10-25,Houston Rockets,86,Orlando Magic,116,0,True,30,2024,False
2023-10-25,Boston Celtics,108,New York Knicks,104,0,False,4,2024,False
2023-10-25,Washington Wizards,120,Indiana Pacers,143,0,True,23,2024,False
2023-10-25,Atlanta Hawks,110,Charlotte Hornets,116,0,True,6,2024,False
2023-10-25,Detroit Pistons,102,Miami Heat,103,0,True,1,2024,False
2023-10-25,Minnesota Timberwolves,94,Toronto Raptors,97,0,True,3,2024,False
2023-10-25,Cleveland Cavaliers,114,Brooklyn Nets,113,0,False,1,2024,False
2023-10-25,New Orleans Pelicans,111,Memphis Grizzlies,104,0,False,7,2024,False
2023-10-25,Oklahoma City Thunder,124,Chicago Bulls,104,0,False,20,2024,False
2023-10-25,Sacramento Kings,130,Utah Jazz,114,0,False,16,2024,False
2023-10-25,Dallas Mavericks,126,San Antonio Spurs,119,0,False,7,2024,False
2023-10-25,Portland Trail Blazers,111,Los Angeles Clippers,123,0,True,12,2024,False
2023-10-26,Philadelphia 76ers,117,Milwaukee Bucks,118,0,True,1,2024,False
2023-10-26,Phoenix Suns,95,Los Angeles Lakers,100,0,True,5,2024,False
2023-10-27,Denver Nuggets,108,Memphis Grizzlies,104,0,False,4,2024,False
2023-10-27,Detroit Pistons,111,Charlotte Hornets,99,0,False,12,2024,False
2023-10-27,New York Knicks,126,Atlanta Hawks,120,0,False,6,2024,False
2023-10-27,Oklahoma City Thunder,108,Cleveland Cavaliers,105,0,False,3,2024,False
2023-10-27,Miami Heat,111,Boston Celtics,119,0,True,8,2024,False
2023-10-27,Toronto Raptors,103,Chicago Bulls,104,1,True,1,2024,False
2023-10-27,Houston Rockets,122,San Antonio Spurs,126,1,True,4,2024,False
2023-10-27,Brooklyn Nets,120,Dallas Mavericks,125,0,True,5,2024,False
2023-10-27,Los Angeles Clippers,118,Utah Jazz,120,0,True,2,2024,False
2023-10-27,Orlando Magic,102,Portland Trail Blazers,97,0,False,5,2024,False
2023-10-27,Golden State Warriors,122,Sacramento Kings,114,0,False,8,2024,False
2023-10-28,Chicago Bulls,102,Detroit Pistons,118,0,True,16,2024,False
2023-10-28,Memphis Grizzlies,106,Washington Wizards,113,0,True,7,2024,False
2023-10-28,New York Knicks,87,New Orleans Pelicans,96,0,True,9,2024,False
2023-10-28,Indiana Pacers,125,Cleveland Cavaliers,113,0,False,12,2024,False
2023-10-28,Philadelphia 76ers,114,Toronto Raptors,107,0,False,7,2024,False
2023-10-28,Miami Heat,90,Minnesota Timberwolves,106,0,True,16,2024,False
2023-10-28,Utah Jazz,104,Phoenix Suns,126,0,True,22,2024,False
2023-10-29,Denver Nuggets,128,Oklahoma City Thunder,95,0,False,33,2024,False
2023-10-29,Golden State Warriors,106,Houston Rockets,95,0,False,11,2024,False
2023-10-29,Atlanta Hawks,127,Milwaukee Bucks,110,0,False,17,2024,False
2023-10-29,Portland Trail Blazers,98,Philadelphia 76ers,126,0,True,28,2024,False
2023-10-29,San Antonio Spurs,83,Los Angeles Clippers,123,0,True,40,2024,False
2023-10-29,Los Angeles Lakers,127,Sacramento Kings,132,1,True,5,2024,False
2023-10-30,Chicago Bulls,112,Indiana Pacers,105,0,False,7,2024,False
2023-10-30,Boston Celtics,126,Washington Wizards,107,0,False,19,2024,False
2023-10-30,Brooklyn Nets,133,Charlotte Hornets,121,0,False,12,2024,False
2023-10-30,Portland Trail Blazers,99,Toronto Raptors,91,0,False,8,2024,False
2023-10-30,Minnesota Timberwolves,113,Atlanta Hawks,127,0,True,14,2024,False
2023-10-30,Dallas Mavericks,125,Memphis Grizzlies,110,0,False,15,2024,False
2023-10-30,Miami Heat,114,Milwaukee Bucks,122,0,True,8,2024,False
2023-10-30,Golden State Warriors,130,New Orleans Pelicans,102,0,False,28,2024,False
2023-10-30,Detroit Pistons,112,Oklahoma City Thunder,124,0,True,12,2024,False
2023-10-30,Utah Jazz,102,Denver Nuggets,110,0,True,8,2024,False
2023-10-30,Orlando Magic,103,Los Angeles Lakers,106,0,True,3,2024,False
2023-10-31,New York Knicks,109,Cleveland Cavaliers,91,0,False,18,2024,False
2023-10-31,San Antonio Spurs,115,Phoenix Suns,114,0,False,1,2024,False
2023-10-31,Orlando Magic,102,Los Angeles Clippers,118,0,True,16,2024,False
2023-11-01,Portland Trail Blazers,110,Detroit Pistons,101,0,False,9,2024,False
2023-11-01,Milwaukee Bucks,111,Toronto Raptors,130,0,True,19,2024,False
2023-11-01,Washington Wizards,121,Atlanta Hawks,130,0,True,9,2024,False
2023-11-01,Indiana Pacers,104,Boston Celtics,155,0,True,51,2024,False
2023-11-01,Brooklyn Nets,109,Miami Heat,105,0,False,4,2024,False
2023-11-01,Cleveland Cavaliers,95,New York Knicks,89,0,False,6,2024,False
2023-11-01,New Orleans Pelicans,110,Oklahoma City Thunder,106,0,False,4,2024,False
2023-11-01,Charlotte Hornets,119,Houston Rockets,128,0,True,9,2024,False
2023-11-01,Denver Nuggets,89,Minnesota Timberwolves,110,0,True,21,2024,False
2023-11-01,Chicago Bulls,105,Dallas Mavericks,114,0,True,9,2024,False
2023-11-01,Memphis Grizzlies,109,Utah Jazz,133,0,True,24,2024,False
2023-11-01,Sacramento Kings,101,Golden State Warriors,102,0,True,1,2024,False
2023-11-01,Los Angeles Clippers,125,Los Angeles Lakers,130,1,True,5,2024,False
2023-11-02,Toronto Raptors,99,Philadelphia 76ers,114,0,True,15,2024,False
2023-11-02,Detroit Pistons,116,New Orleans Pelicans,125,0,True,9,2024,False
2023-11-02,Orlando Magic,115,Utah Jazz,113,0,False,2,2024,False
2023-11-02,San Antonio Spurs,132,Phoenix Suns,121,0,False,11,2024,False
2023-11-03,Cleveland Cavaliers,116,Indiana Pacers,121,0,True,5,2024,False
2023-11-03,New York Knicks,105,Milwaukee Bucks,110,0,True,5,2024,False
2023-11-03,Brooklyn Nets,109,Chicago Bulls,107,0,False,2,2024,False
2023-11-03,Washington Wizards,114,Miami Heat,121,0,True,7,2024,False
2023-11-03,Golden State Warriors,141,Oklahoma City Thunder,139,0,False,2,2024,False
2023-11-03,Dallas Mavericks,114,Denver Nuggets,125,0,True,11,2024,False
2023-11-03,Memphis Grizzlies,113,Portland Trail Blazers,115,1,True,2,2024,False
2023-11-04,Phoenix Suns,100,Philadelphia 76ers,112,0,True,12,2024,False
2023-11-04,Charlotte Hornets,125,Indiana Pacers,124,0,False,1,2024,False
2023-11-04,Atlanta Hawks,123,New Orleans Pelicans,105,0,False,18,2024,False
2023-11-04,Los Angeles Lakers,101,Orlando Magic,120,0,True,19,2024,False
2023-11-04,Boston Celtics,124,Brooklyn Nets,114,0,False,10,2024,False
2023-11-04,Sacramento Kings,89,Houston Rockets,107,0,True,18,2024,False
2023-11-04,Utah Jazz,95,Minnesota Timberwolves,123,0,True,28,2024,False
2023-11-04,Chicago Bulls,101,Denver Nuggets,123,0,True,22,2024,False
2023-11-05,Phoenix Suns,120,Detroit Pistons,106,0,False,14,2024,False
2023-11-05,Toronto Raptors,123,San Antonio Spurs,116,1,False,7,2024,False
2023-11-05,Golden State Warriors,104,Cleveland Cavaliers,115,0,True,11,2024,False
2023-11-05,Charlotte Hornets,118,Dallas Mavericks,124,0,True,6,2024,False
2023-11-05,Memphis Grizzlies,112,Portland Trail Blazers,100,0,False,12,2024,False
2023-11-06,Golden State Warriors,120,Detroit Pistons,109,0,False,11,2024,False
2023-11-06,San Antonio Spurs,111,Indiana Pacers,152,0,True,41,2024,False
2023-11-06,Dallas Mavericks,117,Orlando Magic,102,0,False,15,2024,False
2023-11-06,Washington Wizards,128,Philadelphia 76ers,146,0,True,18,2024,False
2023-11-06,Milwaukee Bucks,129,Brooklyn Nets,125,0,False,4,2024,False
2023-11-06,Los Angeles Lakers,107,Miami Heat,108,0,True,1,2024,False
2023-11-06,Los Angeles Clippers,97,New York Knicks,111,0,True,14,2024,False
2023-11-06,Utah Jazz,113,Chicago Bulls,130,0,True,17,2024,False
2023-11-06,Sacramento Kings,97,Houston Rockets,122,0,True,25,2024,False
2023-11-06,Boston Celtics,109,Minnesota Timberwolves,114,1,True,5,2024,False
2023-11-06,Atlanta Hawks,117,Oklahoma City Thunder,126,0,True,9,2024,False
2023-11-06,New Orleans Pelicans,116,Denver Nuggets,134,0,True,18,2024,False
2023-11-08,Washington Wizards,132,Charlotte Hornets,116,0,False,16,2024,False
2023-11-08,Utah Jazz,118,Indiana Pacers,134,0,True,16,2024,False
2023-11-08,Boston Celtics,103,Philadelphia 76ers,106,0,True,3,2024,False
2023-11-08,Los Angeles Clippers,93,Brooklyn Nets,100,0,True,7,2024,False
2023-11-08,San Antonio Spurs,105,New York Knicks,126,0,True,21,2024,False
2023-11-08,Phoenix Suns,116,Chicago Bulls,115,1,False,1,2024,False
2023-11-08,Los Angeles Lakers,94,Houston Rockets,128,0,True,34,2024,False
2023-11-08,Miami Heat,108,Memphis Grizzlies,102,0,False,6,2024,False
2023-11-08,Detroit Pistons,118,Milwaukee Bucks,120,0,True,2,2024,False
2023-11-08,New Orleans Pelicans,101,Minnesota Timberwolves,122,0,True,21,2024,False
2023-11-08,Cleveland Cavaliers,120,Oklahoma City Thunder,128,0,True,8,2024,False
2023-11-08,Toronto Raptors,127,Dallas Mavericks,116,0,False,11,2024,False
2023-11-08,Golden State Warriors,105,Denver Nuggets,108,0,True,3,2024,False
2023-11-08,Portland Trail Blazers,118,Sacramento Kings,121,1,True,3,2024,False
2023-11-09,Milwaukee Bucks,124,Indiana Pacers,126,0,True,2,2024,False
2023-11-09,Atlanta Hawks,120,Orlando Magic,119,0,False,1,2024,False
2023-11-10,Philadelphia 76ers,114,Detroit Pistons,106,0,False,8,2024,False
2023-11-10,Charlotte Hornets,124,Washington Wizards,117,0,False,7,2024,False
2023-11-10,Brooklyn Nets,107,Boston Celtics,121,0,True,14,2024,False
2023-11-10,New Orleans Pelicans,101,Houston Rockets,104,0,True,3,2024,False
2023-11-10,Utah Jazz,127,Memphis Grizzlies,121,0,False,6,2024,False
2023-11-10,Minnesota Timberwolves,117,San Antonio Spurs,110,0,False,7,2024,False
2023-11-10,Los Angeles Clippers,126,Dallas Mavericks,144,0,True,18,2024,False
2023-11-10,Los Angeles Lakers,122,Phoenix Suns,119,0,False,3,2024,False
2023-11-10,Oklahoma City Thunder,98,Sacramento Kings,105,0,True,7,2024,False
2023-11-11,Milwaukee Bucks,97,Orlando Magic,112,0,True,15,2024,False
2023-11-11,Toronto Raptors,94,Boston Celtics,117,0,True,23,2024,False
2023-11-11,Miami Heat,117,Atlanta Hawks,109,0,False,8,2024,False
2023-11-11,Cleveland Cavaliers,118,Golden State Warriors,110,0,False,8,2024,False
2023-11-12,Charlotte Hornets,107,New York Knicks,129,0,True,22,2024,False
2023-11-12,Washington Wizards,94,Brooklyn Nets,102,0,True,8,2024,False
2023-11-12,Memphis Grizzlies,105,Los Angeles Clippers,101,0,False,4,2024,False
2023-11-12,Indiana Pacers,126,Philadelphia 76ers,137,0,True,11,2024,False
2023-11-12,Detroit Pistons,108,Chicago Bulls,119,0,True,11,2024,False
2023-11-12,Denver Nuggets,104,Houston Rockets,107,0,True,3,2024,False
2023-11-12,Dallas Mavericks,136,New Orleans Pelicans,124,0,False,12,2024,False
2023-11-12,Miami Heat,118,San Antonio Spurs,113,0,False,5,2024,False
2023-11-12,Oklahoma City Thunder,111,Phoenix Suns,99,0,False,12,2024,False
2023-11-12,Minnesota Timberwolves,116,Golden State Warriors,110,0,False,6,2024,False
2023-11-12,Portland Trail Blazers,110,Los Angeles Lakers,116,0,True,6,2024,False
2023-11-13,New York Knicks,98,Boston Celtics,114,0,True,16,2024,False
2023-11-13,Washington Wizards,107,Toronto Raptors,111,0,True,4,2024,False
2023-11-13,Chicago Bulls,109,Milwaukee Bucks,118,0,True,9,2024,False
2023-11-13,Cleveland Cavaliers,120,Sacramento Kings,132,0,True,12,2024,False
2023-11-14,Miami Heat,111,Charlotte Hornets,105,0,False,6,2024,False
2023-11-14,Atlanta Hawks,126,Detroit Pistons,120,0,False,6,2024,False
2023-11-14,Indiana Pacers,132,Philadelphia 76ers,126,0,False,6,2024,False
2023-11-14,Orlando Magic,104,Brooklyn Nets,124,0,True,20,2024,False
2023-11-14,San Antonio Spurs,87,Oklahoma City Thunder,123,0,True,36,2024,False
2023-11-14,Dallas Mavericks,110,New Orleans Pelicans,131,0,True,21,2024,False
2023-11-14,Portland Trail Blazers,99,Utah Jazz,115,0,True,16,2024,False
2023-11-14,Los Angeles Clippers,108,Denver Nuggets,111,0,True,3,2024,False
2023-11-14,Minnesota Timberwolves,104,Golden State Warriors,101,0,False,3,2024,False
2023-11-14,Memphis Grizzlies,107,Los Angeles Lakers,134,0,True,27,2024,False
2023-11-15,Dallas Mavericks,130,Washington Wizards,117,0,False,13,2024,False
2023-11-15,New York Knicks,116,Atlanta Hawks,114,0,False,2,2024,False
2023-11-15,Boston Celtics,117,Philadelphia 76ers,107,0,False,10,2024,False
2023-11-15,Milwaukee Bucks,128,Toronto Raptors,112,0,False,16,2024,False
2023-11-15,Orlando Magic,96,Chicago Bulls,94,0,False,2,2024,False
2023-11-15,Minnesota Timberwolves,115,Phoenix Suns,133,0,True,18,2024,False
2023-11-15,Sacramento Kings,125,Los Angeles Lakers,110,0,False,15,2024,False
2023-11-15,Cleveland Cavaliers,109,Portland Trail Blazers,95,0,False,14,2024,False
2023-11-16,Brooklyn Nets,115,Miami Heat,122,0,True,7,2024,False
2023-11-16,Oklahoma City Thunder,128,Golden State Warriors,109,0,False,19,2024,False
2023-11-17,Milwaukee Bucks,130,Charlotte Hornets,99,0,False,31,2024,False
2023-11-17,New York Knicks,120,Washington Wizards,99,0,False,21,2024,False
2023-11-17,Philadelphia 76ers,126,Atlanta Hawks,116,0,False,10,2024,False
2023-11-17,Detroit Pistons,100,Cleveland Cavaliers,108,0,True,8,2024,False
2023-11-17,Sacramento Kings,129,San Antonio Spurs,120,0,False,9,2024,False
2023-11-17,Boston Celtics,108,Toronto Raptors,105,0,False,3,2024,False
2023-11-17,Orlando Magic,103,Chicago Bulls,97,0,False,6,2024,False
2023-11-17,Denver Nuggets,110,New Orleans Pelicans,115,0,True,5,2024,False
2023-11-17,Los Angeles Lakers,107,Portland Trail Blazers,95,0,False,12,2024,False
2023-11-17,Phoenix Suns,131,Utah Jazz,128,0,False,3,2024,False
2023-11-17,Houston Rockets,100,Los Angeles Clippers,106,0,True,6,2024,False
2023-11-18,New York Knicks,122,Charlotte Hornets,108,0,False,14,2024,False
2023-11-18,Minnesota Timberwolves,121,New Orleans Pelicans,120,0,False,1,2024,False
2023-11-18,Miami Heat,97,Chicago Bulls,102,0,True,5,2024,False
2023-11-18,Dallas Mavericks,125,Milwaukee Bucks,132,0,True,7,2024,False
2023-11-18,Memphis Grizzlies,120,San Antonio Spurs,108,0,False,12,2024,False
2023-11-18,Oklahoma City Thunder,130,Golden State Warriors,123,1,False,7,2024,False
2023-11-19,Philadelphia 76ers,121,Brooklyn Nets,99,0,False,22,2024,False
2023-11-19,Detroit Pistons,113,Toronto Raptors,142,0,True,29,2024,False
2023-11-19,Orlando Magic,128,Indiana Pacers,116,0,False,12,2024,False
2023-11-19,Denver Nuggets,109,Cleveland Cavaliers,121,0,True,12,2024,False
2023-11-19,Sacramento Kings,129,Dallas Mavericks,113,0,False,16,2024,False
2023-11-19,Boston Celtics,102,Memphis Grizzlies,100,0,False,2,2024,False
2023-11-19,Phoenix Suns,140,Utah Jazz,137,2,False,3,2024,False
2023-11-19,Oklahoma City Thunder,134,Portland Trail Blazers,91,0,False,43,2024,False
2023-11-19,Houston Rockets,104,Los Angeles Lakers,105,0,True,1,2024,False
2023-11-20,Boston Celtics,118,Charlotte Hornets,121,1,True,3,2024,False
2023-11-20,Denver Nuggets,107,Detroit Pistons,103,0,False,4,2024,False
2023-11-20,Milwaukee Bucks,142,Washington Wizards,129,0,False,13,2024,False
2023-11-20,Miami Heat,118,Chicago Bulls,100,0,False,18,2024,False
2023-11-20,New York Knicks,100,Minnesota Timberwolves,117,0,True,17,2024,False
2023-11-20,Sacramento Kings,93,New Orleans Pelicans,129,0,True,36,2024,False
2023-11-20,Los Angeles Clippers,124,San Antonio Spurs,99,0,False,25,2024,False
2023-11-20,Houston Rockets,116,Golden State Warriors,121,0,True,5,2024,False
2023-11-21,Toronto Raptors,107,Orlando Magic,126,0,True,19,2024,False
2023-11-21,Indiana Pacers,157,Atlanta Hawks,152,0,False,5,2024,False
2023-11-21,Cleveland Cavaliers,122,Philadelphia 76ers,119,1,False,3,2024,False
2023-11-21,Portland Trail Blazers,107,Phoenix Suns,120,0,True,13,2024,False
2023-11-21,Utah Jazz,99,Los Angeles Lakers,131,0,True,32,2024,False
2023-11-22,Washington Wizards,114,Charlotte Hornets,117,0,True,3,2024,False
2023-11-22,Denver Nuggets,119,Orlando Magic,124,0,True,5,2024,False
2023-11-22,Brooklyn Nets,145,Atlanta Hawks,147,1,True,2,2024,False
2023-11-22,Milwaukee Bucks,116,Boston Celtics,119,0,True,3,2024,False
2023-11-22,Miami Heat,129,Cleveland Cavaliers,96,0,False,33,2024,False
2023-11-22,Toronto Raptors,132,Indiana Pacers,131,0,False,1,2024,False
2023-11-22,Memphis Grizzlies,91,Houston Rockets,111,0,True,20,2024,False
2023-11-22,Philadelphia 76ers,99,Minnesota Timberwolves,112,0,True,13,2024,False
2023-11-22,Sacramento Kings,112,New Orleans Pelicans,117,0,True,5,2024,False
2023-11-22,Chicago Bulls,102,Oklahoma City Thunder,116,0,True,14,2024,False
2023-11-22,Los Angeles Clippers,109,San Antonio Spurs,102,0,False,7,2024,False
2023-11-22,Golden State Warriors,115,Phoenix Suns,123,0,True,8,2024,False
2023-11-22,Utah Jazz,105,Portland Trail Blazers,121,0,True,16,2024,False
2023-11-22,Dallas Mavericks,104,Los Angeles Lakers,101,0,False,3,2024,False
2023-11-24,Boston Celtics,96,Orlando Magic,113,0,True,17,2024,False
2023-11-24,Phoenix Suns,110,Memphis Grizzlies,89,0,False,21,2024,False
2023-11-24,Miami Heat,98,New York Knicks,100,0,True,2,2024,False
2023-11-24,Chicago Bulls,108,Toronto Raptors,121,0,True,13,2024,False
2023-11-24,Denver Nuggets,86,Houston Rockets,105,0,True,19,2024,False
2023-11-24,Detroit Pistons,113,Indiana Pacers,136,0,True,23,2024,False
2023-11-24,Washington Wizards,128,Milwaukee Bucks,131,0,True,3,2024,False
2023-11-24,Sacramento Kings,124,Minnesota Timberwolves,111,0,False,13,2024,False
2023-11-24,San Antonio Spurs,112,Golden State Warriors,118,0,True,6,2024,False
2023-11-24,New Orleans Pelicans,116,Los Angeles Clippers,106,0,False,10,2024,False
2023-11-25,Philadelphia 76ers,127,Oklahoma City Thunder,123,0,False,4,2024,False
2023-11-25,Miami Heat,97,Brooklyn Nets,112,0,True,15,2024,False
2023-11-25,Atlanta Hawks,136,Washington Wizards,108,0,False,28,2024,False
2023-11-25,Los Angeles Lakers,121,Cleveland Cavaliers,115,0,False,6,2024,False
2023-11-25,New Orleans Pelicans,100,Utah Jazz,105,0,True,5,2024,False
2023-11-25,Dallas Mavericks,88,Los Angeles Clippers,107,0,True,19,2024,False
2023-11-26,Portland Trail Blazers,102,Milwaukee Bucks,108,0,True,6,2024,False
2023-11-26,Atlanta Hawks,103,Boston Celtics,113,0,True,10,2024,False
2023-11-26,Minnesota Timberwolves,119,Memphis Grizzlies,97,0,False,22,2024,False
2023-11-26,Phoenix Suns,116,New York Knicks,113,0,False,3,2024,False
2023-11-26,Charlotte Hornets,117,Orlando Magic,130,0,True,13,2024,False
2023-11-26,Chicago Bulls,109,Brooklyn Nets,118,0,True,9,2024,False
2023-11-26,Toronto Raptors,102,Cleveland Cavaliers,105,0,True,3,2024,False
2023-11-26,San Antonio Spurs,120,Denver Nuggets,132,0,True,12,2024,False
2023-11-27,Washington Wizards,126,Detroit Pistons,107,0,False,19,2024,False
2023-11-27,Portland Trail Blazers,114,Indiana Pacers,110,0,False,4,2024,False
2023-11-27,Los Angeles Lakers,94,Philadelphia 76ers,138,0,True,44,2024,False
2023-11-27,New Orleans Pelicans,112,Utah Jazz,114,0,True,2,2024,False
2023-11-27,Denver Nuggets,113,Los Angeles Clippers,104,0,False,9,2024,False
2023-11-28,Chicago Bulls,97,Boston Celtics,124,0,True,27,2024,False
2023-11-28,Toronto Raptors,103,Brooklyn Nets,115,0,True,12,2024,False
2023-11-28,Atlanta Hawks,105,Cleveland Cavaliers,128,0,True,23,2024,False
2023-11-28,Milwaukee Bucks,131,Miami Heat,124,0,False,7,2024,False
2023-11-28,Charlotte Hornets,91,New York Knicks,115,0,True,24,2024,False
2023-11-28,Oklahoma City Thunder,103,Minnesota Timberwolves,106,0,True,3,2024,False
2023-11-28,Houston Rockets,115,Dallas Mavericks,121,0,True,6,2024,False
2023-11-28,Golden State Warriors,123,Sacramento Kings,124,0,True,1,2024,False
2023-11-29,Los Angeles Lakers,133,Detroit Pistons,107,0,False,26,2024,False
2023-11-29,Washington Wizards,120,Orlando Magic,139,0,True,19,2024,False
2023-11-29,Phoenix Suns,105,Toronto Raptors,112,0,True,7,2024,False
2023-11-29,Utah Jazz,91,Memphis Grizzlies,105,0,True,14,2024,False
2023-11-29,Philadelphia 76ers,114,New Orleans Pelicans,124,0,True,10,2024,False
2023-11-29,Houston Rockets,124,Denver Nuggets,134,0,True,10,2024,False
2023-11-29,Los Angeles Clippers,131,Sacramento Kings,117,0,False,14,2024,False
2023-11-30,Portland Trail Blazers,103,Cleveland Cavaliers,95,0,False,8,2024,False
2023-11-30,Charlotte Hornets,129,Brooklyn Nets,128,0,False,1,2024,False
2023-11-30,Indiana Pacers,132,Miami Heat,142,0,True,10,2024,False
2023-11-30,Detroit Pistons,112,New York Knicks,118,0,True,6,2024,False
2023-11-30,Milwaukee Bucks,113,Chicago Bulls,120,1,True,7,2024,False
2023-11-30,Utah Jazz,90,Minnesota Timberwolves,101,0,True,11,2024,False
2023-11-30,Los Angeles Lakers,110,Oklahoma City Thunder,133,0,True,23,2024,False
2023-11-30,Atlanta Hawks,137,San Antonio Spurs,135,0,False,2,2024,False
2023-11-30,Los Angeles Clippers,114,Golden State Warriors,120,0,True,6,2024,False
2023-12-01,Washington Wizards,125,Orlando Magic,130,0,True,5,2024,False
2023-12-01,Philadelphia 76ers,119,Boston Celtics,125,0,True,6,2024,False
2023-12-01,Memphis Grizzlies,108,Dallas Mavericks,94,0,False,14,2024,False
2023-12-01,New York Knicks,119,Toronto Raptors,106,0,False,13,2024,False
2023-12-01,San Antonio Spurs,106,New Orleans Pelicans,121,0,True,15,2024,False
2023-12-01,Denver Nuggets,119,Phoenix Suns,111,0,False,8,2024,False
2023-12-02,Golden State Warriors,112,Los Angeles Clippers,113,0,True,1,2024,False
2023-12-02,Minnesota Timberwolves,123,Charlotte Hornets,117,0,False,6,2024,False
2023-12-02,Orlando Magic,101,Brooklyn Nets,129,0,True,28,2024,False
2023-12-02,Cleveland Cavaliers,110,Detroit Pistons,101,0,False,9,2024,False
2023-12-02,New Orleans Pelicans,118,Chicago Bulls,124,0,True,6,2024,False
2023-12-02,Indiana Pacers,144,Miami Heat,129,0,False,15,2024,False
2023-12-02,Atlanta Hawks,121,Milwaukee Bucks,132,0,True,11,2024,False
2023-12-02,Oklahoma City Thunder,126,Dallas Mavericks,120,0,False,6,2024,False
2023-12-02,Memphis Grizzlies,109,Phoenix Suns,116,0,True,7,2024,False
2023-12-02,Portland Trail Blazers,113,Utah Jazz,118,1,True,5,2024,False
2023-12-02,Denver Nuggets,117,Sacramento Kings,123,0,True,6,2024,False
2023-12-02,Houston Rockets,97,Los Angeles Lakers,107,0,True,10,2024,False
2023-12-04,Boston Celtics,112,Indiana Pacers,122,0,True,10,2024,False
2023-12-04,New Orleans Pelicans,127,Sacramento Kings,117,0,False,10,2024,False
2023-12-05,New York Knicks,122,Milwaukee Bucks,146,0,True,24,2024,False
2023-12-05,Phoenix Suns,103,Los Angeles Lakers,106,0,True,3,2024,False
2023-12-06,Orlando Magic,111,Cleveland Cavaliers,121,0,True,10,2024,False
2023-12-06,Memphis Grizzlies,116,Detroit Pistons,102,0,False,14,2024,False
2023-12-06,Philadelphia 76ers,131,Washington Wizards,126,0,False,5,2024,False
2023-12-06,Brooklyn Nets,114,Atlanta Hawks,113,0,False,1,2024,False
2023-12-06,San Antonio Spurs,94,Minnesota Timberwolves,102,0,True,8,2024,False
2023-12-06,Miami Heat,112,Toronto Raptors,103,0,False,9,2024,False
2023-12-06,Charlotte Hornets,100,Chicago Bulls,111,0,True,11,2024,False
2023-12-06,Oklahoma City Thunder,101,Houston Rockets,110,0,True,9,2024,False
2023-12-06,Utah Jazz,97,Dallas Mavericks,147,0,True,50,2024,False
2023-12-06,Portland Trail Blazers,106,Golden State Warriors,110,0,True,4,2024,False
2023-12-06,Denver Nuggets,102,Los Angeles Clippers,111,0,True,9,2024,False
2023-12-07,Indiana Pacers,128,Milwaukee Bucks,119,0,False,9,2024,False
2023-12-07,New Orleans Pelicans,89,Los Angeles Lakers,133,0,True,44,2024,False
2023-12-08,Toronto Raptors,116,Charlotte Hornets,119,0,True,3,2024,False
2023-12-08,Detroit Pistons,91,Orlando Magic,123,0,True,32,2024,False
2023-12-08,Atlanta Hawks,114,Philadelphia 76ers,125,0,True,11,2024,False
2023-12-08,New York Knicks,123,Boston Celtics,133,0,True,10,2024,False
2023-12-08,Washington Wizards,97,Brooklyn Nets,124,0,True,27,2024,False
2023-12-08,Minnesota Timberwolves,127,Memphis Grizzlies,103,0,False,24,2024,False
2023-12-08,Cleveland Cavaliers,111,Miami Heat,99,0,False,12,2024,False
2023-12-08,Golden State Warriors,136,Oklahoma City Thunder,138,1,True,2,2024,False
2023-12-08,Chicago Bulls,121,San Antonio Spurs,112,0,False,9,2024,False
2023-12-08,Houston Rockets,114,Denver Nuggets,106,0,False,8,2024,False
2023-12-08,Sacramento Kings,114,Phoenix Suns,106,0,False,8,2024,False
2023-12-08,Dallas Mavericks,125,Portland Trail Blazers,112,0,False,13,2024,False
2023-12-08,Los Angeles Clippers,117,Utah Jazz,103,0,False,14,2024,False
2023-12-09,Indiana Pacers,109,Los Angeles Lakers,123,0,True,14,2024,False
2023-12-11,Miami Heat,116,Charlotte Hornets,114,0,False,2,2024,False
2023-12-11,Indiana Pacers,131,Detroit Pistons,123,0,False,8,2024,False
2023-12-11,Cleveland Cavaliers,94,Orlando Magic,104,0,True,10,2024,False
2023-12-11,Washington Wizards,101,Philadelphia 76ers,146,0,True,45,2024,False
2023-12-11,Denver Nuggets,129,Atlanta Hawks,122,0,False,7,2024,False
2023-12-11,Toronto Raptors,130,New York Knicks,136,0,True,6,2024,False
2023-12-11,San Antonio Spurs,82,Houston Rockets,93,0,True,11,2024,False
2023-12-11,Dallas Mavericks,120,Memphis Grizzlies,113,0,False,7,2024,False
2023-12-11,Chicago Bulls,129,Milwaukee Bucks,133,1,True,4,2024,False
2023-12-11,Minnesota Timberwolves,107,New Orleans Pelicans,121,0,True,14,2024,False
2023-12-11,Utah Jazz,120,Oklahoma City Thunder,134,0,True,14,2024,False
2023-12-11,Brooklyn Nets,118,Sacramento Kings,131,0,True,13,2024,False
2023-12-11,Portland Trail Blazers,127,Los Angeles Clippers,132,0,True,5,2024,False
2023-12-12,Cleveland Cavaliers,113,Boston Celtics,120,0,True,7,2024,False
2023-12-12,Los Angeles Lakers,125,Dallas Mavericks,127,0,True,2,2024,False
2023-12-12,Denver Nuggets,114,Chicago Bulls,106,0,False,8,2024,False
2023-12-12,Golden State Warriors,116,Phoenix Suns,119,0,True,3,2024,False
2023-12-12,Sacramento Kings,99,Los Angeles Clippers,119,0,True,20,2024,False
2023-12-13,Philadelphia 76ers,129,Detroit Pistons,111,0,False,18,2024,False
2023-12-13,New Orleans Pelicans,142,Washington Wizards,122,0,False,20,2024,False
2023-12-13,Charlotte Hornets,104,Miami Heat,115,0,True,11,2024,False
2023-12-13,Atlanta Hawks,128,Toronto Raptors,135,0,True,7,2024,False
2023-12-13,Memphis Grizzlies,104,Houston Rockets,117,0,True,13,2024,False
2023-12-13,Indiana Pacers,126,Milwaukee Bucks,140,0,True,14,2024,False
2023-12-13,Los Angeles Lakers,122,San Antonio Spurs,119,0,False,3,2024,False
2023-12-13,Brooklyn Nets,116,Phoenix Suns,112,0,False,4,2024,False
2023-12-13,New York Knicks,113,Utah Jazz,117,0,True,4,2024,False
2023-12-14,Cleveland Cavaliers,107,Boston Celtics,116,0,True,9,2024,False
2023-12-14,Chicago Bulls,124,Miami Heat,116,0,False,8,2024,False
2023-12-14,Minnesota Timberwolves,119,Dallas Mavericks,101,0,False,18,2024,False
2023-12-14,Brooklyn Nets,101,Denver Nuggets,124,0,True,23,2024,False
2023-12-14,Utah Jazz,122,Portland Trail Blazers,114,0,False,8,2024,False
2023-12-14,Oklahoma City Thunder,123,Sacramento Kings,128,0,True,5,2024,False
2023-12-14,Golden State Warriors,113,Los Angeles Clippers,121,0,True,8,2024,False
2023-12-15,New Orleans Pelicans,112,Charlotte Hornets,107,0,False,5,2024,False
2023-12-15,Detroit Pistons,92,Philadelphia 76ers,124,0,True,32,2024,False
2023-12-15,Indiana Pacers,123,Washington Wizards,137,0,True,14,2024,False
2023-12-15,Orlando Magic,111,Boston Celtics,128,0,True,17,2024,False
2023-12-15,Los Angeles Lakers,115,San Antonio Spurs,129,0,True,14,2024,False
2023-12-15,Atlanta Hawks,125,Toronto Raptors,104,0,False,21,2024,False
2023-12-15,Houston Rockets,103,Memphis Grizzlies,96,0,False,7,2024,False
2023-12-15,New York Knicks,139,Phoenix Suns,122,0,False,17,2024,False
2023-12-16,Detroit Pistons,114,Milwaukee Bucks,146,0,True,32,2024,False
2023-12-16,Philadelphia 76ers,135,Charlotte Hornets,82,0,False,53,2024,False
2023-12-16,Atlanta Hawks,119,Cleveland Cavaliers,127,0,True,8,2024,False
2023-12-16,Chicago Bulls,116,Miami Heat,118,0,True,2,2024,False
2023-12-16,Indiana Pacers,109,Minnesota Timberwolves,127,0,True,18,2024,False
2023-12-16,Brooklyn Nets,120,Golden State Warriors,124,0,True,4,2024,False
2023-12-16,Oklahoma City Thunder,118,Denver Nuggets,117,0,False,1,2024,False
2023-12-16,Dallas Mavericks,131,Portland Trail Blazers,120,0,False,11,2024,False
2023-12-16,Utah Jazz,104,Sacramento Kings,125,0,True,21,2024,False
2023-12-16,New York Knicks,122,Los Angeles Clippers,144,0,True,22,2024,False
2023-12-17,Orlando Magic,97,Boston Celtics,114,0,True,17,2024,False
2023-12-17,New Orleans Pelicans,146,San Antonio Spurs,110,0,False,36,2024,False
2023-12-17,Houston Rockets,119,Milwaukee Bucks,128,0,True,9,2024,False
2023-12-17,Washington Wizards,108,Phoenix Suns,112,0,True,4,2024,False
2023-12-17,Golden State Warriors,118,Portland Trail Blazers,114,0,False,4,2024,False
2023-12-18,Houston Rockets,130,Cleveland Cavaliers,135,1,True,5,2024,False
2023-12-18,Los Angeles Clippers,151,Indiana Pacers,127,0,False,24,2024,False
2023-12-18,Chicago Bulls,108,Philadelphia 76ers,104,0,False,4,2024,False
2023-12-18,Detroit Pistons,124,Atlanta Hawks,130,0,True,6,2024,False
2023-12-18,Minnesota Timberwolves,112,Miami Heat,108,0,False,4,2024,False
2023-12-18,Charlotte Hornets,99,Toronto Raptors,114,0,True,15,2024,False
2023-12-18,Memphis Grizzlies,97,Oklahoma City Thunder,116,0,True,19,2024,False
2023-12-18,Dallas Mavericks,104,Denver Nuggets,130,0,True,26,2024,False
2023-12-18,Brooklyn Nets,108,Utah Jazz,125,0,True,17,2024,False
2023-12-18,Washington Wizards,131,Sacramento Kings,143,0,True,12,2024,False
2023-12-18,New York Knicks,114,Los Angeles Lakers,109,0,False,5,2024,False
2023-12-19,Memphis Grizzlies,115,New Orleans Pelicans,113,0,False,2,2024,False
2023-12-19,San Antonio Spurs,119,Milwaukee Bucks,132,0,True,13,2024,False
2023-12-19,Boston Celtics,126,Golden State Warriors,132,1,True,6,2024,False
2023-12-19,Phoenix Suns,104,Portland Trail Blazers,109,0,True,5,2024,False
2023-12-20,Utah Jazz,116,Cleveland Cavaliers,124,0,True,8,2024,False
2023-12-20,Charlotte Hornets,113,Indiana Pacers,144,0,True,31,2024,False
2023-12-20,Miami Heat,115,Orlando Magic,106,0,False,9,2024,False
2023-12-20,Minnesota Timberwolves,113,Philadelphia 76ers,127,0,True,14,2024,False
2023-12-20,New York Knicks,121,Brooklyn Nets,102,0,False,19,2024,False
2023-12-20,Denver Nuggets,113,Toronto Raptors,104,0,False,9,2024,False
2023-12-20,Los Angeles Lakers,108,Chicago Bulls,124,0,True,16,2024,False
2023-12-20,Atlanta Hawks,134,Houston Rockets,127,0,False,7,2024,False
2023-12-20,Los Angeles Clippers,120,Dallas Mavericks,111,0,False,9,2024,False
2023-12-20,Boston Celtics,144,Sacramento Kings,119,0,False,25,2024,False
2023-12-21,Utah Jazz,119,Detroit Pistons,111,0,False,8,2024,False
2023-12-21,New Orleans Pelicans,123,Cleveland Cavaliers,104,0,False,19,2024,False
2023-12-21,San Antonio Spurs,95,Chicago Bulls,114,0,True,19,2024,False
2023-12-21,Indiana Pacers,103,Memphis Grizzlies,116,0,True,13,2024,False
2023-12-21,Orlando Magic,114,Milwaukee Bucks,118,0,True,4,2024,False
2023-12-21,Los Angeles Clippers,115,Oklahoma City Thunder,134,0,True,19,2024,False
2023-12-21,Los Angeles Lakers,111,Minnesota Timberwolves,118,0,True,7,2024,False
2023-12-21,Washington Wizards,118,Portland Trail Blazers,117,0,False,1,2024,False
2023-12-22,Toronto Raptors,111,Philadelphia 76ers,121,0,True,10,2024,False
2023-12-22,Denver Nuggets,122,Brooklyn Nets,117,0,False,5,2024,False
2023-12-22,Dallas Mavericks,96,Houston Rockets,122,0,True,26,2024,False
2023-12-22,Atlanta Hawks,113,Miami Heat,122,0,True,9,2024,False
2023-12-22,Washington Wizards,118,Golden State Warriors,129,0,True,11,2024,False
2023-12-22,Phoenix Suns,105,Sacramento Kings,120,0,True,15,2024,False
2023-12-23,Milwaukee Bucks,130,New York Knicks,111,0,False,19,2024,False
2023-12-23,Boston Celtics,145,Los Angeles Clippers,108,0,False,37,2024,False
2023-12-23,Denver Nuggets,102,Charlotte Hornets,95,0,False,7,2024,False
2023-12-23,Orlando Magic,117,Indiana Pacers,110,0,False,7,2024,False
2023-12-23,Houston Rockets,106,New Orleans Pelicans,104,0,False,2,2024,False
2023-12-23,Memphis Grizzlies,125,Atlanta Hawks,119,0,False,6,2024,False
2023-12-23,Detroit Pistons,115,Brooklyn Nets,126,0,True,11,2024,False
2023-12-23,Utah Jazz,126,Toronto Raptors,119,0,False,7,2024,False
2023-12-23,Cleveland Cavaliers,109,Chicago Bulls,95,0,False,14,2024,False
2023-12-23,Los Angeles Lakers,129,Oklahoma City Thunder,120,0,False,9,2024,False
2023-12-23,San Antonio Spurs,119,Dallas Mavericks,144,0,True,25,2024,False
2023-12-23,Portland Trail Blazers,106,Golden State Warriors,126,0,True,20,2024,False
2023-12-23,Minnesota Timberwolves,110,Sacramento Kings,98,0,False,12,2024,False
2023-12-25,Milwaukee Bucks,122,New York Knicks,129,0,True,7,2024,False
2023-12-25,Golden State Warriors,114,Denver Nuggets,120,0,True,6,2024,False
2023-12-25,Boston Celtics,126,Los Angeles Lakers,115,0,False,11,2024,False
2023-12-25,Philadelphia 76ers,113,Miami Heat,119,0,True,6,2024,False
2023-12-25,Dallas Mavericks,128,Phoenix Suns,114,0,False,14,2024,False
2023-12-26,Brooklyn Nets,118,Detroit Pistons,112,0,False,6,2024,False
2023-12-26,Orlando Magic,127,Washington Wizards,119,0,False,8,2024,False
2023-12-26,Atlanta Hawks,113,Chicago Bulls,118,0,True,5,2024,False
2023-12-26,Indiana Pacers,123,Houston Rockets,117,0,False,6,2024,False
2023-12-26,Memphis Grizzlies,116,New Orleans Pelicans,115,1,False,1,2024,False
2023-12-26,Minnesota Timberwolves,106,Oklahoma City Thunder,129,0,True,23,2024,False
2023-12-26,Utah Jazz,130,San Antonio Spurs,118,0,False,12,2024,False
2023-12-26,Sacramento Kings,113,Portland Trail Blazers,130,0,True,17,2024,False
2023-12-26,Charlotte Hornets,104,Los Angeles Clippers,113,0,True,9,2024,False
2023-12-27,Philadelphia 76ers,112,Orlando Magic,92,0,False,20,2024,False
2023-12-27,Toronto Raptors,132,Washington Wizards,102,0,False,30,2024,False
2023-12-27,Milwaukee Bucks,144,Brooklyn Nets,122,0,False,22,2024,False
2023-12-27,Phoenix Suns,129,Houston Rockets,113,0,False,16,2024,False
2023-12-27,New York Knicks,120,Oklahoma City Thunder,129,0,True,9,2024,False
2023-12-27,Cleveland Cavaliers,113,Dallas Mavericks,110,0,False,3,2024,False
2023-12-28,Detroit Pistons,122,Boston Celtics,128,1,True,6,2024,False
2023-12-28,Indiana Pacers,120,Chicago Bulls,104,0,False,16,2024,False
2023-12-28,Dallas Mavericks,110,Minnesota Timberwolves,118,0,True,8,2024,False
2023-12-28,Utah Jazz,105,New Orleans Pelicans,112,0,True,7,2024,False
2023-12-28,Memphis Grizzlies,105,Denver Nuggets,142,0,True,37,2024,False
2023-12-28,Miami Heat,114,Golden State Warriors,102,0,False,12,2024,False
2023-12-28,San Antonio Spurs,118,Portland Trail Blazers,105,0,False,13,2024,False
2023-12-28,Charlotte Hornets,112,Los Angeles Lakers,133,0,True,21,2024,False
2023-12-29,New York Knicks,108,Orlando Magic,117,0,True,9,2024,False
2023-12-29,Brooklyn Nets,104,Washington Wizards,110,0,True,6,2024,False
2023-12-29,Sacramento Kings,117,Atlanta Hawks,110,0,False,7,2024,False
2023-12-29,Toronto Raptors,118,Boston Celtics,120,0,True,2,2024,False
2023-12-29,Milwaukee Bucks,119,Cleveland Cavaliers,111,0,False,8,2024,False
2023-12-29,Philadelphia 76ers,131,Houston Rockets,127,0,False,4,2024,False
2023-12-29,Oklahoma City Thunder,119,Denver Nuggets,93,0,False,26,2024,False
2023-12-29,Charlotte Hornets,119,Phoenix Suns,133,0,True,14,2024,False
2023-12-29,San Antonio Spurs,128,Portland Trail Blazers,134,0,True,6,2024,False
2023-12-29,Memphis Grizzlies,106,Los Angeles Clippers,117,0,True,11,2024,False
2023-12-30,Miami Heat,109,Utah Jazz,117,0,True,8,2024,False
2023-12-30,Toronto Raptors,127,Detroit Pistons,129,0,True,2,2024,False
2023-12-30,New York Knicks,126,Indiana Pacers,140,0,True,14,2024,False
2023-12-30,Philadelphia 76ers,92,Chicago Bulls,105,0,True,13,2024,False
2023-12-30,Los Angeles Lakers,106,Minnesota Timberwolves,108,0,True,2,2024,False
2023-12-30,Dallas Mavericks,132,Golden State Warriors,122,0,False,10,2024,False
2023-12-31,Atlanta Hawks,130,Washington Wizards,126,0,False,4,2024,False
2023-12-31,Los Angeles Lakers,109,New Orleans Pelicans,129,0,True,20,2024,False
2023-12-31,Brooklyn Nets,108,Oklahoma City Thunder,124,0,True,16,2024,False
2023-12-31,Boston Celtics,134,San Antonio Spurs,101,0,False,33,2024,False
2023-12-31,Sacramento Kings,123,Memphis Grizzlies,92,0,False,31,2024,False
2023-12-31,Orlando Magic,107,Phoenix Suns,112,0,True,5,2024,False
2024-01-01,Minnesota Timberwolves,106,New York Knicks,112,0,True,6,2024,False
2024-01-01,Cleveland Cavaliers,121,Toronto Raptors,124,0,True,3,2024,False
2024-01-01,Detroit Pistons,113,Houston Rockets,136,0,True,23,2024,False
2024-01-01,Indiana Pacers,122,Milwaukee Bucks,113,0,False,9,2024,False
2024-01-01,Charlotte Hornets,93,Denver Nuggets,111,0,True,18,2024,False
2024-01-01,Portland Trail Blazers,88,Phoenix Suns,109,0,True,21,2024,False
2024-01-01,Dallas Mavericks,90,Utah Jazz,127,0,True,37,2024,False
2024-01-01,Miami Heat,104,Los Angeles Clippers,121,0,True,17,2024,False
2024-01-02,Chicago Bulls,97,Philadelphia 76ers,110,0,True,13,2024,False
2024-01-02,San Antonio Spurs,98,Memphis Grizzlies,106,0,True,8,2024,False
2024-01-02,Brooklyn Nets,85,New Orleans Pelicans,112,0,True,27,2024,False
2024-01-02,Boston Celtics,123,Oklahoma City Thunder,127,0,True,4,2024,False
2024-01-02,Orlando Magic,115,Golden State Warriors,121,0,True,6,2024,False
2024-01-02,Charlotte Hornets,111,Sacramento Kings,104,0,False,7,2024,False
2024-01-03,Washington Wizards,101,Cleveland Cavaliers,140,0,True,39,2024,False
2024-01-03,Milwaukee Bucks,130,Indiana Pacers,142,0,True,12,2024,False
2024-01-03,Oklahoma City Thunder,138,Atlanta Hawks,141,0,True,3,2024,False
2024-01-03,Brooklyn Nets,101,Houston Rockets,112,0,True,11,2024,False
2024-01-03,Toronto Raptors,116,Memphis Grizzlies,111,0,False,5,2024,False
2024-01-03,New Orleans Pelicans,117,Minnesota Timberwolves,106,0,False,11,2024,False
2024-01-03,Portland Trail Blazers,97,Dallas Mavericks,126,0,True,29,2024,False
2024-01-03,Chicago Bulls,100,New York Knicks,116,0,True,16,2024,False
2024-01-03,Los Angeles Clippers,131,Phoenix Suns,122,0,False,9,2024,False
2024-01-03,Detroit Pistons,148,Utah Jazz,154,1,True,6,2024,False
2024-01-03,Miami Heat,110,Los Angeles Lakers,96,0,False,14,2024,False
2024-01-03,Orlando Magic,135,Sacramento Kings,138,2,True,3,2024,False
2024-01-04,Milwaukee Bucks,125,San Antonio Spurs,121,0,False,4,2024,False
2024-01-04,Denver Nuggets,130,Golden State Warriors,127,0,False,3,2024,False
2024-01-05,Utah Jazz,97,Boston Celtics,126,0,True,29,2024,False
2024-01-05,Atlanta Hawks,116,Indiana Pacers,150,0,True,34,2024,False
2024-01-05,Oklahoma City Thunder,115,Brooklyn Nets,124,0,True,9,2024,False
2024-01-05,Washington Wizards,90,Cleveland Cavaliers,114,0,True,24,2024,False
2024-01-05,New York Knicks,128,Philadelphia 76ers,92,0,False,36,2024,False
2024-01-05,Charlotte Hornets,91,Chicago Bulls,104,0,True,13,2024,False
2024-01-05,Minnesota Timberwolves,122,Houston Rockets,95,0,False,27,2024,False
2024-01-05,Los Angeles Clippers,111,New Orleans Pelicans,95,0,False,16,2024,False
2024-01-05,Portland Trail Blazers,103,Dallas Mavericks,139,0,True,36,2024,False
2024-01-05,Orlando Magic,122,Denver Nuggets,120,0,False,2,2024,False
2024-01-05,Miami Heat,97,Phoenix Suns,113,0,True,16,2024,False
2024-01-05,Detroit Pistons,109,Golden State Warriors,113,0,True,4,2024,False
2024-01-05,Memphis Grizzlies,127,Los Angeles Lakers,113,0,False,14,2024,False
2024-01-05,Toronto Raptors,130,Sacramento Kings,135,0,True,5,2024,False
2024-01-06,Boston Celtics,118,Indiana Pacers,101,0,False,17,2024,False
2024-01-06,New York Knicks,121,Washington Wizards,105,0,False,16,2024,False
2024-01-06,Utah Jazz,120,Philadelphia 76ers,109,0,False,11,2024,False
2024-01-06,Milwaukee Bucks,108,Houston Rockets,112,0,True,4,2024,False
2024-01-07,San Antonio Spurs,115,Cleveland Cavaliers,117,0,True,2,2024,False
2024-01-07,Portland Trail Blazers,134,Brooklyn Nets,127,1,False,7,2024,False
2024-01-07,Atlanta Hawks,110,Orlando Magic,117,1,True,7,2024,False
2024-01-07,New Orleans Pelicans,133,Sacramento Kings,100,0,False,33,2024,False
2024-01-07,Minnesota Timberwolves,108,Dallas Mavericks,115,0,True,7,2024,False
2024-01-07,Detroit Pistons,114,Denver Nuggets,131,0,True,17,2024,False
2024-01-07,Memphis Grizzlies,121,Phoenix Suns,115,0,False,6,2024,False
2024-01-07,Toronto Raptors,133,Golden State Warriors,118,0,False,15,2024,False
2024-01-07,Los Angeles Clippers,103,Los Angeles Lakers,106,0,True,3,2024,False
2024-01-08,Chicago Bulls,119,Charlotte Hornets,112,1,False,7,2024,False
2024-01-08,Boston Celtics,131,Indiana Pacers,133,0,True,2,2024,False
2024-01-08,Oklahoma City Thunder,136,Washington Wizards,128,0,False,8,2024,False
2024-01-08,Houston Rockets,113,Miami Heat,120,0,True,7,2024,False
2024-01-08,Utah Jazz,132,Milwaukee Bucks,116,0,False,16,2024,False
2024-01-08,Phoenix Suns,111,Los Angeles Clippers,138,0,True,27,2024,False
2024-01-09,Sacramento Kings,131,Detroit Pistons,110,0,False,21,2024,False
2024-01-09,Minnesota Timberwolves,113,Orlando Magic,92,0,False,21,2024,False
2024-01-09,Portland Trail Blazers,84,New York Knicks,112,0,True,28,2024,False
2024-01-09,Memphis Grizzlies,120,Dallas Mavericks,103,0,False,17,2024,False
2024-01-09,Toronto Raptors,131,Los Angeles Lakers,132,0,True,1,2024,False
2024-01-10,Minnesota Timberwolves,120,Boston Celtics,127,1,True,7,2024,False
2024-01-10,Sacramento Kings,123,Charlotte Hornets,98,0,False,25,2024,False
2024-01-10,San Antonio Spurs,130,Detroit Pistons,108,0,False,22,2024,False
2024-01-10,Washington Wizards,104,Indiana Pacers,112,0,True,8,2024,False
2024-01-10,Philadelphia 76ers,132,Atlanta Hawks,139,1,True,7,2024,False
2024-01-10,Oklahoma City Thunder,128,Miami Heat,120,0,False,8,2024,False
2024-01-10,Houston Rockets,119,Chicago Bulls,124,1,True,5,2024,False
2024-01-10,New Orleans Pelicans,141,Golden State Warriors,105,0,False,36,2024,False
2024-01-10,Denver Nuggets,111,Utah Jazz,124,0,True,13,2024,False
2024-01-10,Toronto Raptors,120,Los Angeles Clippers,126,0,True,6,2024,False
2024-01-11,Brooklyn Nets,102,Cleveland Cavaliers,111,0,True,9,2024,False
2024-01-11,Boston Celtics,102,Milwaukee Bucks,135,0,True,33,2024,False
2024-01-11,Portland Trail Blazers,77,Oklahoma City Thunder,139,0,True,62,2024,False
2024-01-11,New York Knicks,124,Dallas Mavericks,128,0,True,4,2024,False
2024-01-11,Phoenix Suns,127,Los Angeles Lakers,109,0,False,18,2024,False
2024-01-12,Indiana Pacers,126,Atlanta Hawks,108,0,False,18,2024,False
2024-01-12,Houston Rockets,112,Detroit Pistons,110,0,False,2,2024,False
2024-01-12,Sacramento Kings,93,Philadelphia 76ers,112,0,True,19,2024,False
2024-01-12,Golden State Warriors,140,Chicago Bulls,131,0,False,9,2024,False
2024-01-12,Los Angeles Clippers,128,Memphis Grizzlies,119,0,False,9,2024,False
2024-01-12,Orlando Magic,96,Miami Heat,99,0,True,3,2024,False
2024-01-12,Portland Trail Blazers,93,Minnesota Timberwolves,116,0,True,23,2024,False
2024-01-12,Charlotte Hornets,99,San Antonio Spurs,135,0,True,36,2024,False
2024-01-12,Toronto Raptors,113,Utah Jazz,145,0,True,32,2024,False
2024-01-12,New Orleans Pelicans,113,Denver Nuggets,125,0,True,12,2024,False
2024-01-13,Houston Rockets,113,Boston Celtics,145,0,True,32,2024,False
2024-01-13,Washington Wizards,127,Atlanta Hawks,99,0,False,28,2024,False
2024-01-13,New York Knicks,106,Memphis Grizzlies,94,0,False,12,2024,False
2024-01-13,Golden State Warriors,118,Milwaukee Bucks,129,0,True,11,2024,False
2024-01-13,Orlando Magic,100,Oklahoma City Thunder,112,0,True,12,2024,False
2024-01-13,New Orleans Pelicans,118,Dallas Mavericks,108,0,False,10,2024,False
2024-01-13,Chicago Bulls,122,San Antonio Spurs,116,0,False,6,2024,False
2024-01-13,Los Angeles Lakers,125,Utah Jazz,132,0,True,7,2024,False
2024-01-14,Indiana Pacers,109,Denver Nuggets,117,0,True,8,2024,False
2024-01-14,Charlotte Hornets,87,Miami Heat,104,0,True,17,2024,False
2024-01-14,Sacramento Kings,142,Milwaukee Bucks,143,1,True,1,2024,False
2024-01-14,Los Angeles Clippers,105,Minnesota Timberwolves,109,0,True,4,2024,False
2024-01-14,Phoenix Suns,127,Portland Trail Blazers,116,0,False,11,2024,False
2024-01-15,Houston Rockets,115,Philadelphia 76ers,124,0,True,9,2024,False
2024-01-15,New Orleans Pelicans,120,Dallas Mavericks,125,0,True,5,2024,False
2024-01-15,Orlando Magic,98,New York Knicks,94,0,False,4,2024,False
2024-01-15,Detroit Pistons,129,Washington Wizards,117,0,False,12,2024,False
2024-01-15,San Antonio Spurs,99,Atlanta Hawks,109,0,True,10,2024,False
2024-01-15,Golden State Warriors,107,Memphis Grizzlies,116,0,True,9,2024,False
2024-01-15,Chicago Bulls,91,Cleveland Cavaliers,109,0,True,18,2024,False
2024-01-15,Miami Heat,96,Brooklyn Nets,95,1,False,1,2024,False
2024-01-15,Boston Celtics,105,Toronto Raptors,96,0,False,9,2024,False
2024-01-15,Indiana Pacers,105,Utah Jazz,132,0,True,27,2024,False
2024-01-15,Oklahoma City Thunder,105,Los Angeles Lakers,112,0,True,7,2024,False
2024-01-16,Denver Nuggets,121,Philadelphia 76ers,126,0,True,5,2024,False
2024-01-16,Sacramento Kings,117,Phoenix Suns,119,0,True,2,2024,False
2024-01-16,Oklahoma City Thunder,117,Los Angeles Clippers,128,0,True,11,2024,False
2024-01-17,Minnesota Timberwolves,124,Detroit Pistons,117,0,False,7,2024,False
2024-01-17,Orlando Magic,104,Atlanta Hawks,106,0,True,2,2024,False
2024-01-17,San Antonio Spurs,98,Boston Celtics,117,0,True,19,2024,False
2024-01-17,Milwaukee Bucks,95,Cleveland Cavaliers,135,0,True,40,2024,False
2024-01-17,Houston Rockets,94,New York Knicks,109,0,True,15,2024,False
2024-01-17,Miami Heat,97,Toronto Raptors,121,0,True,24,2024,False
2024-01-17,Charlotte Hornets,112,New Orleans Pelicans,132,0,True,20,2024,False
2024-01-17,Dallas Mavericks,110,Los Angeles Lakers,127,0,True,17,2024,False
2024-01-17,Brooklyn Nets,103,Portland Trail Blazers,105,0,True,2,2024,False
2024-01-18,Washington Wizards,109,New York Knicks,113,0,True,4,2024,False
2024-01-18,Chicago Bulls,116,Toronto Raptors,110,0,False,6,2024,False
2024-01-18,Oklahoma City Thunder,134,Utah Jazz,129,0,False,5,2024,False
2024-01-18,Memphis Grizzlies,103,Minnesota Timberwolves,118,0,True,15,2024,False
2024-01-18,Indiana Pacers,126,Sacramento Kings,121,0,False,5,2024,False
2024-01-19,San Antonio Spurs,120,Charlotte Hornets,124,0,True,4,2024,False
2024-01-19,Philadelphia 76ers,124,Orlando Magic,109,0,False,15,2024,False
2024-01-19,Denver Nuggets,102,Boston Celtics,100,0,False,2,2024,False
2024-01-19,Atlanta Hawks,109,Miami Heat,108,0,False,1,2024,False
2024-01-19,Phoenix Suns,123,New Orleans Pelicans,109,0,False,14,2024,False
2024-01-19,Indiana Pacers,115,Portland Trail Blazers,118,0,True,3,2024,False
2024-01-19,Brooklyn Nets,130,Los Angeles Lakers,112,0,False,18,2024,False
2024-01-20,Milwaukee Bucks,141,Detroit Pistons,135,0,False,6,2024,False
2024-01-20,Philadelphia 76ers,97,Charlotte Hornets,89,0,False,8,2024,False
2024-01-20,San Antonio Spurs,131,Washington Wizards,127,0,False,4,2024,False
2024-01-20,Cleveland Cavaliers,116,Atlanta Hawks,95,0,False,21,2024,False
2024-01-20,Toronto Raptors,100,New York Knicks,126,0,True,26,2024,False
2024-01-20,Memphis Grizzlies,96,Chicago Bulls,125,0,True,29,2024,False
2024-01-20,Utah Jazz,126,Houston Rockets,127,1,True,1,2024,False
2024-01-20,Oklahoma City Thunder,102,Minnesota Timberwolves,97,0,False,5,2024,False
2024-01-21,Brooklyn Nets,114,Los Angeles Clippers,125,0,True,11,2024,False
2024-01-21,Miami Heat,87,Orlando Magic,105,0,True,18,2024,False
2024-01-21,Denver Nuggets,113,Washington Wizards,104,0,False,9,2024,False
2024-01-21,Boston Celtics,116,Houston Rockets,107,0,False,9,2024,False
2024-01-21,Indiana Pacers,110,Phoenix Suns,117,0,True,7,2024,False
2024-01-21,Portland Trail Blazers,110,Los Angeles Lakers,134,0,True,24,2024,False
2024-01-22,Milwaukee Bucks,122,Detroit Pistons,113,0,False,9,2024,False
2024-01-22,Cleveland Cavaliers,126,Orlando Magic,99,0,False,27,2024,False
2024-01-22,San Antonio Spurs,123,Philadelphia 76ers,133,0,True,10,2024,False
2024-01-22,Memphis Grizzlies,108,Toronto Raptors,100,0,False,8,2024,False
2024-01-22,Charlotte Hornets,128,Minnesota Timberwolves,125,0,False,3,2024,False
2024-01-22,Boston Celtics,119,Dallas Mavericks,110,0,False,9,2024,False
2024-01-22,Chicago Bulls,113,Phoenix Suns,115,0,True,2,2024,False
2024-01-22,Atlanta Hawks,107,Sacramento Kings,122,0,True,15,2024,False
2024-01-23,Denver Nuggets,114,Indiana Pacers,109,0,False,5,2024,False
2024-01-23,New York Knicks,108,Brooklyn Nets,103,0,False,5,2024,False
2024-01-23,Utah Jazz,124,New Orleans Pelicans,153,0,True,29,2024,False
2024-01-23,Portland Trail Blazers,109,Oklahoma City Thunder,111,0,True,2,2024,False
2024-01-23,Los Angeles Lakers,116,Los Angeles Clippers,127,0,True,11,2024,False
2024-01-24,Charlotte Hornets,106,Detroit Pistons,113,0,True,7,2024,False
2024-01-24,Minnesota Timberwolves,118,Washington Wizards,107,0,False,11,2024,False
2024-01-24,Memphis Grizzlies,105,Miami Heat,96,0,False,9,2024,False
2024-01-24,Portland Trail Blazers,137,Houston Rockets,131,1,False,6,2024,False
2024-01-24,Cleveland Cavaliers,116,Milwaukee Bucks,126,0,True,10,2024,False
2024-01-24,Phoenix Suns,132,Dallas Mavericks,109,0,False,23,2024,False
2024-01-24,Oklahoma City Thunder,140,San Antonio Spurs,114,0,False,26,2024,False
2024-01-24,Atlanta Hawks,112,Golden State Warriors,134,0,True,22,2024,False
2024-01-25,Philadelphia 76ers,122,Indiana Pacers,134,0,True,12,2024,False
2024-01-25,Utah Jazz,123,Washington Wizards,108,0,False,15,2024,False
2024-01-25,Minnesota Timberwolves,96,Brooklyn Nets,94,0,False,2,2024,False
2024-01-25,Boston Celtics,143,Miami Heat,110,0,False,33,2024,False
2024-01-25,Denver Nuggets,84,New York Knicks,122,0,True,38,2024,False
2024-01-25,Sacramento Kings,134,Golden State Warriors,133,0,False,1,2024,False
2024-01-25,Chicago Bulls,132,Los Angeles Lakers,141,0,True,9,2024,False
2024-01-26,Dallas Mavericks,148,Atlanta Hawks,143,0,False,5,2024,False
2024-01-26,Houston Rockets,138,Charlotte Hornets,104,0,False,34,2024,False
2024-01-26,Phoenix Suns,131,Indiana Pacers,133,0,True,2,2024,False
2024-01-26,Los Angeles Clippers,127,Toronto Raptors,107,0,False,20,2024,False
2024-01-26,Orlando Magic,106,Memphis Grizzlies,107,0,True,1,2024,False
2024-01-26,Cleveland Cavaliers,112,Milwaukee Bucks,100,0,False,12,2024,False
2024-01-26,Oklahoma City Thunder,107,New Orleans Pelicans,83,0,False,24,2024,False
2024-01-26,Portland Trail Blazers,100,San Antonio Spurs,116,0,True,16,2024,False
2024-01-27,Washington Wizards,118,Detroit Pistons,104,0,False,14,2024,False
2024-01-27,Miami Heat,109,New York Knicks,125,0,True,16,2024,False
2024-01-27,Philadelphia 76ers,105,Denver Nuggets,111,0,True,6,2024,False
2024-01-27,Houston Rockets,104,Brooklyn Nets,106,0,True,2,2024,False
2024-01-27,Los Angeles Clippers,115,Boston Celtics,96,0,False,19,2024,False
2024-01-27,Utah Jazz,134,Charlotte Hornets,122,0,False,12,2024,False
2024-01-27,New Orleans Pelicans,117,Milwaukee Bucks,141,0,True,24,2024,False
2024-01-27,Los Angeles Lakers,145,Golden State Warriors,144,2,False,1,2024,False
2024-01-27,Minnesota Timberwolves,112,San Antonio Spurs,113,0,True,1,2024,False
2024-01-27,Sacramento Kings,120,Dallas Mavericks,115,0,False,5,2024,False
2024-01-28,Oklahoma City Thunder,104,Detroit Pistons,120,0,True,16,2024,False
2024-01-28,Memphis Grizzlies,110,Indiana Pacers,116,0,True,6,2024,False
2024-01-28,Toronto Raptors,125,Atlanta Hawks,126,0,True,1,2024,False
2024-01-28,Phoenix Suns,98,Orlando Magic,113,0,True,15,2024,False
2024-01-28,Chicago Bulls,104,Portland Trail Blazers,96,0,False,8,2024,False
2024-01-29,New York Knicks,113,Charlotte Hornets,92,0,False,21,2024,False
2024-01-29,Los Angeles Clippers,108,Cleveland Cavaliers,118,0,True,10,2024,False
2024-01-29,New Orleans Pelicans,112,Boston Celtics,118,0,True,6,2024,False
2024-01-29,Utah Jazz,114,Brooklyn Nets,147,0,True,33,2024,False
2024-01-29,Phoenix Suns,118,Miami Heat,105,0,False,13,2024,False
2024-01-29,Los Angeles Lakers,119,Houston Rockets,135,0,True,16,2024,False
2024-01-29,Sacramento Kings,103,Memphis Grizzlies,94,0,False,9,2024,False
2024-01-29,Minnesota Timberwolves,107,Oklahoma City Thunder,101,0,False,6,2024,False
2024-01-29,Washington Wizards,118,San Antonio Spurs,113,0,False,5,2024,False
2024-01-29,Orlando Magic,129,Dallas Mavericks,131,0,True,2,2024,False
2024-01-29,Milwaukee Bucks,107,Denver Nuggets,113,0,True,6,2024,False
2024-01-29,Philadelphia 76ers,104,Portland Trail Blazers,130,0,True,26,2024,False
2024-01-30,Los Angeles Lakers,122,Atlanta Hawks,138,0,True,16,2024,False
2024-01-30,Indiana Pacers,124,Boston Celtics,129,0,True,5,2024,False
2024-01-30,Utah Jazz,103,New York Knicks,118,0,True,15,2024,False
2024-01-30,Toronto Raptors,118,Chicago Bulls,107,0,False,11,2024,False
2024-01-30,Philadelphia 76ers,107,Golden State Warriors,119,0,True,12,2024,False
2024-01-31,Chicago Bulls,117,Charlotte Hornets,110,0,False,7,2024,False
2024-01-31,Detroit Pistons,121,Cleveland Cavaliers,128,0,True,7,2024,False
2024-01-31,Los Angeles Clippers,125,Washington Wizards,109,0,False,16,2024,False
2024-01-31,Sacramento Kings,106,Miami Heat,115,0,True,9,2024,False
2024-01-31,New Orleans Pelicans,110,Houston Rockets,99,0,False,11,2024,False
2024-01-31,Dallas Mavericks,87,Minnesota Timberwolves,121,0,True,34,2024,False
2024-01-31,Denver Nuggets,100,Oklahoma City Thunder,105,0,True,5,2024,False
2024-01-31,Orlando Magic,108,San Antonio Spurs,98,0,False,10,2024,False
2024-01-31,Phoenix Suns,136,Brooklyn Nets,120,0,False,16,2024,False
2024-01-31,Milwaukee Bucks,116,Portland Trail Blazers,119,0,True,3,2024,False
2024-02-01,Los Angeles Lakers,114,Boston Celtics,105,0,False,9,2024,False
2024-02-01,Indiana Pacers,105,New York Knicks,109,0,True,4,2024,False
2024-02-01,Cleveland Cavaliers,108,Memphis Grizzlies,101,0,False,7,2024,False
2024-02-01,Philadelphia 76ers,127,Utah Jazz,124,0,False,3,2024,False
2024-02-02,Los Angeles Clippers,136,Detroit Pistons,125,0,False,11,2024,False
2024-02-02,Miami Heat,110,Washington Wizards,102,0,False,8,2024,False
2024-02-02,Phoenix Suns,120,Atlanta Hawks,129,0,True,9,2024,False
2024-02-02,Sacramento Kings,133,Indiana Pacers,122,0,False,11,2024,False
2024-02-02,Toronto Raptors,106,Houston Rockets,135,0,True,29,2024,False
2024-02-02,Golden State Warriors,121,Memphis Grizzlies,101,0,False,20,2024,False
2024-02-02,Orlando Magic,108,Minnesota Timberwolves,106,0,False,2,2024,False
2024-02-02,Charlotte Hornets,106,Oklahoma City Thunder,126,0,True,20,2024,False
2024-02-02,New Orleans Pelicans,114,San Antonio Spurs,113,0,False,1,2024,False
2024-02-02,Portland Trail Blazers,108,Denver Nuggets,120,0,True,12,2024,False
2024-02-03,Brooklyn Nets,136,Philadelphia 76ers,121,0,False,15,2024,False
2024-02-03,Golden State Warriors,134,Atlanta Hawks,141,1,True,7,2024,False
2024-02-03,Sacramento Kings,123,Chicago Bulls,115,0,False,8,2024,False
2024-02-03,Milwaukee Bucks,129,Dallas Mavericks,117,0,False,12,2024,False
2024-02-03,Los Angeles Lakers,113,New York Knicks,105,0,False,8,2024,False
2024-02-03,Cleveland Cavaliers,117,San Antonio Spurs,101,0,False,16,2024,False
2024-02-04,Orlando Magic,111,Detroit Pistons,99,0,False,12,2024,False
2024-02-04,Phoenix Suns,140,Washington Wizards,112,0,False,28,2024,False
2024-02-04,Memphis Grizzlies,91,Boston Celtics,131,0,True,40,2024,False
2024-02-04,Indiana Pacers,115,Charlotte Hornets,99,0,False,16,2024,False
2024-02-04,Los Angeles Clippers,103,Miami Heat,95,0,False,8,2024,False
2024-02-04,Houston Rockets,90,Minnesota Timberwolves,111,0,True,21,2024,False
2024-02-04,Toronto Raptors,127,Oklahoma City Thunder,135,2,True,8,2024,False
2024-02-04,Milwaukee Bucks,108,Utah Jazz,123,0,True,15,2024,False
2024-02-04,Portland Trail Blazers,103,Denver Nuggets,112,0,True,9,2024,False
2024-02-05,Los Angeles Lakers,124,Charlotte Hornets,118,0,False,6,2024,False
2024-02-05,Sacramento Kings,110,Cleveland Cavaliers,136,0,True,26,2024,False
2024-02-05,Dallas Mavericks,118,Philadelphia 76ers,102,0,False,16,2024,False
2024-02-05,Los Angeles Clippers,149,Atlanta Hawks,144,0,False,5,2024,False
2024-02-05,Golden State Warriors,109,Brooklyn Nets,98,0,False,11,2024,False
2024-02-05,Toronto Raptors,100,New Orleans Pelicans,138,0,True,38,2024,False
2024-02-06,Houston Rockets,129,Indiana Pacers,132,0,True,3,2024,False
2024-02-06,Dallas Mavericks,119,Brooklyn Nets,107,0,False,12,2024,False
2024-02-06,Orlando Magic,95,Miami Heat,121,0,True,26,2024,False
2024-02-06,Memphis Grizzlies,113,New York Knicks,123,0,True,10,2024,False
2024-02-06,Minnesota Timberwolves,123,Chicago Bulls,129,1,True,6,2024,False
2024-02-06,Oklahoma City Thunder,117,Utah Jazz,124,0,True,7,2024,False
2024-02-06,Milwaukee Bucks,106,Phoenix Suns,114,0,True,8,2024,False
2024-02-07,Toronto Raptors,123,Charlotte Hornets,117,0,False,6,2024,False
2024-02-07,Cleveland Cavaliers,114,Washington Wizards,106,0,False,8,2024,False
2024-02-07,Atlanta Hawks,117,Boston Celtics,125,0,True,8,2024,False
2024-02-07,San Antonio Spurs,104,Miami Heat,116,0,True,12,2024,False
2024-02-07,Golden State Warriors,127,Philadelphia 76ers,104,0,False,23,2024,False
2024-02-07,New Orleans Pelicans,117,Los Angeles Clippers,106,0,False,11,2024,False
2024-02-07,Detroit Pistons,133,Sacramento Kings,120,0,False,13,2024,False
2024-02-08,Golden State Warriors,131,Indiana Pacers,109,0,False,22,2024,False
2024-02-08,San Antonio Spurs,111,Orlando Magic,127,0,True,16,2024,False
2024-02-08,Cleveland Cavaliers,118,Brooklyn Nets,95,0,False,23,2024,False
2024-02-08,Dallas Mavericks,122,New York Knicks,108,0,False,14,2024,False
2024-02-08,Chicago Bulls,118,Memphis Grizzlies,110,0,False,8,2024,False
2024-02-08,Minnesota Timberwolves,129,Milwaukee Bucks,105,0,False,24,2024,False
2024-02-08,Utah Jazz,115,Phoenix Suns,129,0,True,14,2024,False
2024-02-08,Denver Nuggets,114,Los Angeles Lakers,106,0,False,8,2024,False
2024-02-08,Detroit Pistons,128,Portland Trail Blazers,122,1,False,6,2024,False
2024-02-09,Atlanta Hawks,127,Philadelphia 76ers,121,0,False,6,2024,False
2024-02-09,Washington Wizards,129,Boston Celtics,133,0,True,4,2024,False
2024-02-09,Houston Rockets,104,Toronto Raptors,107,0,True,3,2024,False
2024-02-09,Charlotte Hornets,84,Milwaukee Bucks,120,0,True,36,2024,False
2024-02-09,Denver Nuggets,106,Sacramento Kings,135,0,True,29,2024,False
2024-02-09,New Orleans Pelicans,122,Los Angeles Lakers,139,0,True,17,2024,False
2024-02-10,Oklahoma City Thunder,111,Dallas Mavericks,146,0,True,35,2024,False
2024-02-10,Detroit Pistons,106,Los Angeles Clippers,112,0,True,6,2024,False
2024-02-10,San Antonio Spurs,103,Brooklyn Nets,123,0,True,20,2024,False
2024-02-10,Memphis Grizzlies,106,Charlotte Hornets,115,0,True,9,2024,False
2024-02-10,Chicago Bulls,108,Orlando Magic,114,1,True,6,2024,False
2024-02-10,Philadelphia 76ers,119,Washington Wizards,113,0,False,6,2024,False
2024-02-10,Houston Rockets,113,Atlanta Hawks,122,0,True,9,2024,False
2024-02-10,Indiana Pacers,125,New York Knicks,111,0,False,14,2024,False
2024-02-10,Cleveland Cavaliers,119,Toronto Raptors,95,0,False,24,2024,False
2024-02-10,Phoenix Suns,112,Golden State Warriors,113,0,True,1,2024,False
2024-02-10,New Orleans Pelicans,93,Portland Trail Blazers,84,0,False,9,2024,False
2024-02-11,Boston Celtics,110,Miami Heat,106,0,False,4,2024,False
2024-02-11,Sacramento Kings,113,Oklahoma City Thunder,127,0,True,14,2024,False
2024-02-12,Indiana Pacers,102,Charlotte Hornets,111,0,True,9,2024,False
2024-02-12,Philadelphia 76ers,123,Cleveland Cavaliers,121,0,False,2,2024,False
2024-02-12,Chicago Bulls,136,Atlanta Hawks,126,0,False,10,2024,False
2024-02-12,San Antonio Spurs,122,Toronto Raptors,99,0,False,23,2024,False
2024-02-12,New York Knicks,103,Houston Rockets,105,0,True,2,2024,False
2024-02-12,New Orleans Pelicans,96,Memphis Grizzlies,87,0,False,9,2024,False
2024-02-12,Denver Nuggets,95,Milwaukee Bucks,112,0,True,17,2024,False
2024-02-12,Washington Wizards,104,Dallas Mavericks,112,0,True,8,2024,False
2024-02-12,Golden State Warriors,129,Utah Jazz,107,0,False,22,2024,False
2024-02-12,Minnesota Timberwolves,121,Los Angeles Clippers,100,0,False,21,2024,False
2024-02-13,Boston Celtics,118,Brooklyn Nets,110,0,False,8,2024,False
2024-02-13,Oklahoma City Thunder,127,Orlando Magic,113,0,False,14,2024,False
2024-02-13,Miami Heat,123,Milwaukee Bucks,97,0,False,26,2024,False
2024-02-13,Sacramento Kings,125,Phoenix Suns,130,0,True,5,2024,False
2024-02-13,Minnesota Timberwolves,121,Portland Trail Blazers,109,0,False,12,2024,False
2024-02-13,Detroit Pistons,111,Los Angeles Lakers,125,0,True,14,2024,False
2024-02-14,Atlanta Hawks,99,Charlotte Hornets,122,0,True,23,2024,False
2024-02-14,New York Knicks,100,Orlando Magic,118,0,True,18,2024,False
2024-02-14,Miami Heat,109,Philadelphia 76ers,104,0,False,5,2024,False
2024-02-14,Brooklyn Nets,86,Boston Celtics,136,0,True,50,2024,False
2024-02-14,Chicago Bulls,105,Cleveland Cavaliers,108,0,True,3,2024,False
2024-02-14,Indiana Pacers,127,Toronto Raptors,125,0,False,2,2024,False
2024-02-14,Houston Rockets,113,Memphis Grizzlies,121,0,True,8,2024,False
2024-02-14,Washington Wizards,126,New Orleans Pelicans,133,0,True,7,2024,False
2024-02-14,San Antonio Spurs,93,Dallas Mavericks,116,0,True,23,2024,False
2024-02-14,Sacramento Kings,102,Denver Nuggets,98,0,False,4,2024,False
2024-02-14,Detroit Pistons,100,Phoenix Suns,116,0,True,16,2024,False
2024-02-14,Los Angeles Lakers,138,Utah Jazz,122,0,False,16,2024,False
2024-02-14,Los Angeles Clippers,130,Golden State Warriors,125,0,False,5,2024,False
2024-02-15,Milwaukee Bucks,110,Memphis Grizzlies,113,0,True,3,2024,False
2024-02-15,Golden State Warriors,140,Utah Jazz,137,0,False,3,2024,False
2024-02-15,Minnesota Timberwolves,128,Portland Trail Blazers,91,0,False,37,2024,False
2024-02-22,Orlando Magic,116,Cleveland Cavaliers,109,0,False,7,2024,False
2024-02-22,Detroit Pistons,115,Indiana Pacers,129,0,True,14,2024,False
2024-02-22,New York Knicks,110,Philadelphia 76ers,96,0,False,14,2024,False
2024-02-22,Brooklyn Nets,93,Toronto Raptors,121,0,True,28,2024,False
2024-02-22,Phoenix Suns,113,Dallas Mavericks,123,0,True,10,2024,False
2024-02-22,Boston Celtics,129,Chicago Bulls,112,0,False,17,2024,False
2024-02-22,Houston Rockets,105,New Orleans Pelicans,127,0,True,22,2024,False
2024-02-22,Los Angeles Clippers,107,Oklahoma City Thunder,129,0,True,22,2024,False
2024-02-22,Washington Wizards,110,Denver Nuggets,130,0,True,20,2024,False
2024-02-22,Charlotte Hornets,115,Utah Jazz,107,0,False,8,2024,False
2024-02-22,Los Angeles Lakers,110,Golden State Warriors,128,0,True,18,2024,False
2024-02-22,San Antonio Spurs,122,Sacramento Kings,127,0,True,5,2024,False
2024-02-23,Toronto Raptors,123,Atlanta Hawks,121,0,False,2,2024,False
2024-02-23,Cleveland Cavaliers,97,Philadelphia 76ers,104,0,True,7,2024,False
2024-02-23,Phoenix Suns,110,Houston Rockets,114,0,True,4,2024,False
2024-02-23,Los Angeles Clippers,101,Memphis Grizzlies,95,0,False,6,2024,False
2024-02-23,Miami Heat,106,New Orleans Pelicans,95,0,False,11,2024,False
2024-02-23,Washington Wizards,106,Oklahoma City Thunder,147,0,True,41,2024,False
2024-02-23,Charlotte Hornets,84,Golden State Warriors,97,0,True,13,2024,False
2024-02-23,Milwaukee Bucks,112,Minnesota Timberwolves,107,0,False,5,2024,False
2024-02-23,Denver Nuggets,127,Portland Trail Blazers,112,0,False,15,2024,False
2024-02-23,San Antonio Spurs,118,Los Angeles Lakers,123,0,True,5,2024,False
2024-02-24,Orlando Magic,112,Detroit Pistons,109,0,False,3,2024,False
2024-02-24,Boston Celtics,116,New York Knicks,102,0,False,14,2024,False
2024-02-24,Brooklyn Nets,86,Minnesota Timberwolves,101,0,True,15,2024,False
2024-02-25,Milwaukee Bucks,119,Philadelphia 76ers,98,0,False,21,2024,False
2024-02-25,Los Angeles Lakers,113,Phoenix Suns,123,0,True,10,2024,False
2024-02-25,Dallas Mavericks,111,Indiana Pacers,133,0,True,22,2024,False
2024-02-25,Cleveland Cavaliers,114,Washington Wizards,105,0,False,9,2024,False
2024-02-25,Orlando Magic,92,Atlanta Hawks,109,0,True,17,2024,False
2024-02-25,Denver Nuggets,119,Golden State Warriors,103,0,False,16,2024,False
2024-02-25,Oklahoma City Thunder,123,Houston Rockets,110,0,False,13,2024,False
2024-02-25,Chicago Bulls,114,New Orleans Pelicans,106,0,False,8,2024,False
2024-02-25,San Antonio Spurs,109,Utah Jazz,128,0,True,19,2024,False
2024-02-25,Charlotte Hornets,93,Portland Trail Blazers,80,0,False,13,2024,False
2024-02-25,Sacramento Kings,123,Los Angeles Clippers,107,0,False,16,2024,False
2024-02-26,Toronto Raptors,130,Indiana Pacers,122,0,False,8,2024,False
2024-02-26,Detroit Pistons,111,New York Knicks,113,0,True,2,2024,False
2024-02-26,Brooklyn Nets,111,Memphis Grizzlies,86,0,False,25,2024,False
2024-02-26,Miami Heat,121,Sacramento Kings,110,0,False,11,2024,False
2024-02-27,Dallas Mavericks,119,Cleveland Cavaliers,121,0,True,2,2024,False
2024-02-27,Brooklyn Nets,81,Orlando Magic,108,0,True,27,2024,False
2024-02-27,Golden State Warriors,123,Washington Wizards,112,0,False,11,2024,False
2024-02-27,Utah Jazz,97,Atlanta Hawks,124,0,True,27,2024,False
2024-02-27,Philadelphia 76ers,99,Boston Celtics,117,0,True,18,2024,False
2024-02-27,New Orleans Pelicans,115,New York Knicks,92,0,False,23,2024,False
2024-02-27,Detroit Pistons,105,Chicago Bulls,95,0,False,10,2024,False
2024-02-27,Charlotte Hornets,85,Milwaukee Bucks,123,0,True,38,2024,False
2024-02-27,San Antonio Spurs,105,Minnesota Timberwolves,114,0,True,9,2024,False
2024-02-27,Houston Rockets,95,Oklahoma City Thunder,112,0,True,17,2024,False
2024-02-27,Miami Heat,106,Portland Trail Blazers,96,0,False,10,2024,False
2024-02-28,New Orleans Pelicans,114,Indiana Pacers,123,0,True,9,2024,False
2024-02-28,Dallas Mavericks,136,Toronto Raptors,125,0,False,11,2024,False
2024-02-28,Cleveland Cavaliers,123,Chicago Bulls,132,2,True,9,2024,False
2024-02-28,Memphis Grizzlies,101,Minnesota Timberwolves,110,0,True,9,2024,False
2024-02-28,Sacramento Kings,96,Denver Nuggets,117,0,True,21,2024,False
2024-02-28,Los Angeles Lakers,116,Los Angeles Clippers,112,0,False,4,2024,False
2024-02-29,Milwaukee Bucks,111,Charlotte Hornets,99,0,False,12,2024,False
2024-02-29,Utah Jazz,107,Orlando Magic,115,0,True,8,2024,False
2024-02-29,Atlanta Hawks,97,Brooklyn Nets,124,0,True,27,2024,False
2024-02-29,Golden State Warriors,110,New York Knicks,99,0,False,11,2024,False
2024-02-29,Oklahoma City Thunder,118,San Antonio Spurs,132,0,True,14,2024,False
2024-02-29,Houston Rockets,105,Phoenix Suns,110,0,True,5,2024,False
2024-02-29,Miami Heat,97,Denver Nuggets,103,0,True,6,2024,False
2024-02-29,Washington Wizards,131,Los Angeles Lakers,134,1,True,3,2024,False
2024-03-01,Cleveland Cavaliers,110,Detroit Pistons,100,0,False,10,2024,False
2024-03-01,Charlotte Hornets,114,Philadelphia 76ers,121,0,True,7,2024,False
2024-03-01,Dallas Mavericks,110,Boston Celtics,138,0,True,28,2024,False
2024-03-01,Golden State Warriors,120,Toronto Raptors,105,0,False,15,2024,False
2024-03-01,Portland Trail Blazers,122,Memphis Grizzlies,92,0,False,30,2024,False
2024-03-01,Sacramento Kings,124,Minnesota Timberwolves,120,1,False,4,2024,False
2024-03-01,Indiana Pacers,102,New Orleans Pelicans,129,0,True,27,2024,False
2024-03-01,Milwaukee Bucks,113,Chicago Bulls,97,0,False,16,2024,False
2024-03-01,Washington Wizards,115,Los Angeles Clippers,140,0,True,25,2024,False
2024-03-02,Atlanta Hawks,102,Brooklyn Nets,114,0,True,12,2024,False
2024-03-02,Utah Jazz,120,Miami Heat,126,0,True,6,2024,False
2024-03-02,Portland Trail Blazers,107,Memphis Grizzlies,100,1,False,7,2024,False
2024-03-02,Denver Nuggets,124,Los Angeles Lakers,114,0,False,10,2024,False
2024-03-02,Houston Rockets,118,Phoenix Suns,109,0,False,9,2024,False
2024-03-03,Philadelphia 76ers,120,Dallas Mavericks,116,0,False,4,2024,False
2024-03-03,Golden State Warriors,88,Boston Celtics,140,0,True,52,2024,False
2024-03-03,Los Angeles Clippers,89,Minnesota Timberwolves,88,0,False,1,2024,False
2024-03-03,Detroit Pistons,91,Orlando Magic,113,0,True,22,2024,False
2024-03-03,Charlotte Hornets,106,Toronto Raptors,111,0,True,5,2024,False
2024-03-03,New York Knicks,107,Cleveland Cavaliers,98,0,False,9,2024,False
2024-03-03,Indiana Pacers,105,San Antonio Spurs,117,0,True,12,2024,False
2024-03-03,Oklahoma City Thunder,118,Phoenix Suns,110,0,False,8,2024,False
2024-03-04,Memphis Grizzlies,106,Brooklyn Nets,102,0,False,4,2024,False
2024-03-04,Los Angeles Clippers,106,Milwaukee Bucks,113,0,True,7,2024,False
2024-03-04,Portland Trail Blazers,114,Minnesota Timberwolves,119,0,True,5,2024,False
2024-03-04,Washington Wizards,115,Utah Jazz,127,0,True,12,2024,False
2024-03-04,Chicago Bulls,113,Sacramento Kings,109,0,False,4,2024,False
2024-03-04,Oklahoma City Thunder,104,Los Angeles Lakers,116,0,True,12,2024,False
2024-03-05,Orlando Magic,101,Charlotte Hornets,89,0,False,12,2024,False
2024-03-05,Philadelphia 76ers,107,Brooklyn Nets,112,0,True,5,2024,False
2024-03-05,Boston Celtics,104,Cleveland Cavaliers,105,0,True,1,2024,False
2024-03-05,Detroit Pistons,110,Miami Heat,118,0,True,8,2024,False
2024-03-05,Atlanta Hawks,116,New York Knicks,100,0,False,16,2024,False
2024-03-05,New Orleans Pelicans,139,Toronto Raptors,98,0,False,41,2024,False
2024-03-05,San Antonio Spurs,101,Houston Rockets,114,0,True,13,2024,False
2024-03-05,Indiana Pacers,137,Dallas Mavericks,120,0,False,17,2024,False
2024-03-05,Phoenix Suns,117,Denver Nuggets,107,1,False,10,2024,False
2024-03-06,Orlando Magic,119,Washington Wizards,109,0,False,10,2024,False
2024-03-06,Cleveland Cavaliers,101,Atlanta Hawks,112,0,True,11,2024,False
2024-03-06,Los Angeles Clippers,122,Houston Rockets,116,0,False,6,2024,False
2024-03-06,Memphis Grizzlies,115,Philadelphia 76ers,109,0,False,6,2024,False
2024-03-06,Chicago Bulls,119,Utah Jazz,117,0,False,2,2024,False
2024-03-06,Milwaukee Bucks,90,Golden State Warriors,125,0,True,35,2024,False
2024-03-06,Oklahoma City Thunder,128,Portland Trail Blazers,120,0,False,8,2024,False
2024-03-06,Sacramento Kings,130,Los Angeles Lakers,120,0,False,10,2024,False
2024-03-07,Brooklyn Nets,112,Detroit Pistons,118,0,True,6,2024,False
2024-03-07,Minnesota Timberwolves,113,Indiana Pacers,111,0,False,2,2024,False
2024-03-07,Miami Heat,108,Dallas Mavericks,114,0,True,6,2024,False
2024-03-07,Toronto Raptors,113,Phoenix Suns,120,0,True,7,2024,False
2024-03-07,Boston Celtics,109,Denver Nuggets,115,0,True,6,2024,False
2024-03-07,Chicago Bulls,125,Golden State Warriors,122,0,False,3,2024,False
2024-03-07,San Antonio Spurs,129,Sacramento Kings,131,0,True,2,2024,False
2024-03-08,New Orleans Pelicans,103,Philadelphia 76ers,95,0,False,8,2024,False
2024-03-08,Charlotte Hornets,100,Washington Wizards,112,0,True,12,2024,False
2024-03-08,Minnesota Timberwolves,104,Cleveland Cavaliers,113,1,True,9,2024,False
2024-03-08,Orlando Magic,74,New York Knicks,98,0,True,24,2024,False
2024-03-08,Atlanta Hawks,99,Memphis Grizzlies,92,0,False,7,2024,False
2024-03-08,Miami Heat,100,Oklahoma City Thunder,107,0,True,7,2024,False
2024-03-08,Milwaukee Bucks,122,Los Angeles Lakers,123,0,True,1,2024,False
2024-03-08,Houston Rockets,123,Portland Trail Blazers,107,0,False,16,2024,False
2024-03-09,Chicago Bulls,102,Los Angeles Clippers,112,0,True,10,2024,False
2024-03-09,Brooklyn Nets,99,Charlotte Hornets,110,0,True,11,2024,False
2024-03-09,Dallas Mavericks,142,Detroit Pistons,124,0,False,18,2024,False
2024-03-09,San Antonio Spurs,126,Golden State Warriors,113,0,False,13,2024,False
2024-03-09,Boston Celtics,117,Phoenix Suns,107,0,False,10,2024,False
2024-03-09,Utah Jazz,121,Denver Nuggets,142,0,True,21,2024,False
2024-03-09,Toronto Raptors,118,Portland Trail Blazers,128,1,True,10,2024,False
2024-03-10,Milwaukee Bucks,124,Los Angeles Clippers,117,0,False,7,2024,False
2024-03-10,New Orleans Pelicans,116,Atlanta Hawks,103,0,False,13,2024,False
2024-03-10,Washington Wizards,110,Miami Heat,108,0,False,2,2024,False
2024-03-10,Indiana Pacers,111,Orlando Magic,97,0,False,14,2024,False
2024-03-10,Houston Rockets,112,Sacramento Kings,104,0,False,8,2024,False
2024-03-10,Brooklyn Nets,120,Cleveland Cavaliers,101,0,False,19,2024,False
2024-03-10,Philadelphia 76ers,79,New York Knicks,73,0,False,6,2024,False
2024-03-10,Memphis Grizzlies,93,Oklahoma City Thunder,124,0,True,31,2024,False
2024-03-10,Minnesota Timberwolves,109,Los Angeles Lakers,120,0,True,11,2024,False
2024-03-11,Charlotte Hornets,97,Detroit Pistons,114,0,True,17,2024,False
2024-03-11,Phoenix Suns,117,Cleveland Cavaliers,111,0,False,6,2024,False
2024-03-11,Dallas Mavericks,127,Chicago Bulls,92,0,False,35,2024,False
2024-03-11,Golden State Warriors,112,San Antonio Spurs,102,0,False,10,2024,False
2024-03-11,Toronto Raptors,119,Denver Nuggets,125,0,True,6,2024,False
2024-03-11,Boston Celtics,121,Portland Trail Blazers,99,0,False,22,2024,False
2024-03-12,Philadelphia 76ers,79,New York Knicks,106,0,True,27,2024,False
2024-03-12,Washington Wizards,97,Memphis Grizzlies,109,0,True,12,2024,False
2024-03-12,Indiana Pacers,121,Oklahoma City Thunder,111,0,False,10,2024,False
2024-03-12,Houston Rockets,103,San Antonio Spurs,101,0,False,2,2024,False
2024-03-12,Boston Celtics,123,Utah Jazz,107,0,False,16,2024,False
2024-03-12,Minnesota Timberwolves,118,Los Angeles Clippers,100,0,False,18,2024,False
2024-03-12,Milwaukee Bucks,94,Sacramento Kings,129,0,True,35,2024,False
2024-03-13,Toronto Raptors,104,Detroit Pistons,113,0,True,9,2024,False
2024-03-13,Brooklyn Nets,106,Orlando Magic,114,0,True,8,2024,False
2024-03-13,Chicago Bulls,132,Indiana Pacers,129,1,False,3,2024,False
2024-03-13,Denver Nuggets,100,Miami Heat,88,0,False,12,2024,False
2024-03-13,Charlotte Hornets,110,Memphis Grizzlies,98,0,False,12,2024,False
2024-03-13,Cleveland Cavaliers,116,New Orleans Pelicans,95,0,False,21,2024,False
2024-03-13,Golden State Warriors,99,Dallas Mavericks,109,0,True,10,2024,False
2024-03-13,Atlanta Hawks,102,Portland Trail Blazers,106,0,True,4,2024,False
2024-03-13,Los Angeles Lakers,107,Sacramento Kings,120,0,True,13,2024,False
2024-03-14,Phoenix Suns,112,Boston Celtics,127,0,True,15,2024,False
2024-03-14,Los Angeles Clippers,126,Chicago Bulls,111,0,False,15,2024,False
2024-03-14,Washington Wizards,119,Houston Rockets,135,0,True,16,2024,False
2024-03-14,Philadelphia 76ers,105,Milwaukee Bucks,114,0,True,9,2024,False
2024-03-14,Dallas Mavericks,119,Oklahoma City Thunder,126,0,True,7,2024,False
2024-03-14,New York Knicks,105,Portland Trail Blazers,93,0,False,12,2024,False
2024-03-15,Phoenix Suns,107,Charlotte Hornets,96,0,False,11,2024,False
2024-03-15,Miami Heat,108,Detroit Pistons,95,0,False,13,2024,False
2024-03-15,Orlando Magic,113,Toronto Raptors,103,0,False,10,2024,False
2024-03-15,Los Angeles Clippers,104,New Orleans Pelicans,112,0,True,8,2024,False
2024-03-15,Denver Nuggets,117,San Antonio Spurs,106,0,False,11,2024,False
2024-03-15,Atlanta Hawks,122,Utah Jazz,124,0,True,2,2024,False
2024-03-16,Cleveland Cavaliers,103,Houston Rockets,117,0,True,14,2024,False
2024-03-16,Brooklyn Nets,100,Indiana Pacers,121,0,True,21,2024,False
2024-03-16,Portland Trail Blazers,107,New Orleans Pelicans,126,0,True,19,2024,False
2024-03-16,Charlotte Hornets,98,Philadelphia 76ers,109,0,True,11,2024,False
2024-03-16,Washington Wizards,98,Chicago Bulls,127,0,True,29,2024,False
2024-03-16,Oklahoma City Thunder,118,Memphis Grizzlies,112,0,False,6,2024,False
2024-03-16,Golden State Warriors,128,Los Angeles Lakers,121,0,False,7,2024,False
2024-03-16,Minnesota Timberwolves,119,Utah Jazz,100,0,False,19,2024,False
2024-03-16,New York Knicks,98,Sacramento Kings,91,0,False,7,2024,False
2024-03-17,Phoenix Suns,129,Milwaukee Bucks,140,0,True,11,2024,False
2024-03-17,Miami Heat,104,Detroit Pistons,101,0,False,3,2024,False
2024-03-17,Denver Nuggets,105,Dallas Mavericks,107,0,True,2,2024,False
2024-03-17,Toronto Raptors,96,Orlando Magic,111,0,True,15,2024,False
2024-03-17,Boston Celtics,130,Washington Wizards,104,0,False,26,2024,False
2024-03-17,Brooklyn Nets,115,San Antonio Spurs,122,1,True,7,2024,False
2024-03-17,Atlanta Hawks,110,Los Angeles Clippers,93,0,False,17,2024,False
2024-03-18,Cleveland Cavaliers,108,Indiana Pacers,103,0,False,5,2024,False
2024-03-18,Detroit Pistons,94,Boston Celtics,119,0,True,25,2024,False
2024-03-18,Miami Heat,91,Philadelphia 76ers,98,0,True,7,2024,False
2024-03-18,Portland Trail Blazers,107,Chicago Bulls,110,0,True,3,2024,False
2024-03-18,Minnesota Timberwolves,114,Utah Jazz,104,0,False,10,2024,False
2024-03-18,New York Knicks,119,Golden State Warriors,112,0,False,7,2024,False
2024-03-18,Memphis Grizzlies,111,Sacramento Kings,121,1,True,10,2024,False
2024-03-18,Atlanta Hawks,105,Los Angeles Lakers,136,0,True,31,2024,False
2024-03-19,Charlotte Hornets,92,Orlando Magic,112,0,True,20,2024,False
2024-03-19,Houston Rockets,137,Washington Wizards,114,0,False,23,2024,False
2024-03-19,New Orleans Pelicans,104,Brooklyn Nets,91,0,False,13,2024,False
2024-03-19,Dallas Mavericks,113,San Antonio Spurs,107,0,False,6,2024,False
2024-03-19,Denver Nuggets,115,Minnesota Timberwolves,112,0,False,3,2024,False
2024-03-20,Miami Heat,107,Cleveland Cavaliers,104,0,False,3,2024,False
2024-03-20,Indiana Pacers,122,Detroit Pistons,103,0,False,19,2024,False
2024-03-20,Milwaukee Bucks,119,Boston Celtics,122,0,True,3,2024,False
2024-03-20,Sacramento Kings,123,Toronto Raptors,89,0,False,34,2024,False
2024-03-20,Utah Jazz,107,Oklahoma City Thunder,119,0,True,12,2024,False
2024-03-20,Memphis Grizzlies,116,Golden State Warriors,137,0,True,21,2024,False
2024-03-20,Philadelphia 76ers,102,Phoenix Suns,115,0,True,13,2024,False
2024-03-20,Los Angeles Clippers,116,Portland Trail Blazers,103,0,False,13,2024,False
2024-03-21,New Orleans Pelicans,106,Orlando Magic,121,0,True,15,2024,False
2024-03-21,Sacramento Kings,102,Washington Wizards,109,0,True,7,2024,False
2024-03-21,Chicago Bulls,117,Houston Rockets,127,0,True,10,2024,False
2024-03-21,Brooklyn Nets,108,Milwaukee Bucks,115,0,True,7,2024,False
2024-03-21,Utah Jazz,97,Dallas Mavericks,113,0,True,16,2024,False
2024-03-21,New York Knicks,100,Denver Nuggets,113,0,True,13,2024,False
2024-03-21,Atlanta Hawks,115,Phoenix Suns,128,0,True,13,2024,False
2024-03-22,Boston Celtics,129,Detroit Pistons,102,0,False,27,2024,False
2024-03-22,Oklahoma City Thunder,123,Toronto Raptors,103,0,False,20,2024,False
2024-03-22,New Orleans Pelicans,111,Miami Heat,88,0,False,23,2024,False
2024-03-22,Cleveland Cavaliers,91,Minnesota Timberwolves,104,0,True,13,2024,False
2024-03-22,Memphis Grizzlies,99,San Antonio Spurs,97,0,False,2,2024,False
2024-03-22,Indiana Pacers,123,Golden State Warriors,111,0,False,12,2024,False
2024-03-22,Los Angeles Clippers,125,Portland Trail Blazers,117,0,False,8,2024,False
2024-03-22,Philadelphia 76ers,94,Los Angeles Lakers,101,0,True,7,2024,False
2024-03-23,Brooklyn Nets,93,New York Knicks,105,0,True,12,2024,False
2024-03-23,Sacramento Kings,109,Orlando Magic,107,0,False,2,2024,False
2024-03-23,Charlotte Hornets,91,Atlanta Hawks,132,0,True,41,2024,False
2024-03-23,Boston Celtics,124,Chicago Bulls,113,0,False,11,2024,False
2024-03-23,Utah Jazz,119,Houston Rockets,147,0,True,28,2024,False
2024-03-23,Phoenix Suns,131,San Antonio Spurs,106,0,False,25,2024,False
2024-03-23,Toronto Raptors,109,Washington Wizards,112,0,True,3,2024,False
2024-03-23,Denver Nuggets,114,Portland Trail Blazers,111,0,False,3,2024,False
2024-03-24,New Orleans Pelicans,114,Detroit Pistons,101,0,False,13,2024,False
2024-03-24,Philadelphia 76ers,121,Los Angeles Clippers,107,0,False,14,2024,False
2024-03-24,Cleveland Cavaliers,84,Miami Heat,121,0,True,37,2024,False
2024-03-24,Oklahoma City Thunder,93,Milwaukee Bucks,118,0,True,25,2024,False
2024-03-24,Golden State Warriors,110,Minnesota Timberwolves,114,0,True,4,2024,False
2024-03-24,Indiana Pacers,145,Los Angeles Lakers,150,0,True,5,2024,False
2024-03-25,Charlotte Hornets,92,Cleveland Cavaliers,115,0,True,23,2024,False
2024-03-25,Boston Celtics,118,Atlanta Hawks,120,0,True,2,2024,False
2024-03-25,Detroit Pistons,99,New York Knicks,124,0,True,25,2024,False
2024-03-25,Brooklyn Nets,96,Toronto Raptors,88,0,False,8,2024,False
2024-03-25,Washington Wizards,107,Chicago Bulls,105,0,False,2,2024,False
2024-03-25,Portland Trail Blazers,92,Houston Rockets,110,0,True,18,2024,False
2024-03-25,Phoenix Suns,102,San Antonio Spurs,104,0,True,2,2024,False
2024-03-25,Memphis Grizzlies,103,Denver Nuggets,128,0,True,25,2024,False
2024-03-25,Dallas Mavericks,115,Utah Jazz,105,0,False,10,2024,False
2024-03-25,Philadelphia 76ers,96,Sacramento Kings,108,0,True,12,2024,False
2024-03-25,Indiana Pacers,133,Los Angeles Clippers,116,0,False,17,2024,False
2024-03-26,Golden State Warriors,113,Miami Heat,92,0,False,21,2024,False
2024-03-26,Los Angeles Lakers,128,Milwaukee Bucks,124,2,False,4,2024,False
2024-03-26,Oklahoma City Thunder,119,New Orleans Pelicans,112,0,False,7,2024,False
2024-03-26,Dallas Mavericks,132,Sacramento Kings,96,0,False,36,2024,False
2024-03-27,Cleveland Cavaliers,111,Charlotte Hornets,118,0,True,7,2024,False
2024-03-27,Golden State Warriors,101,Orlando Magic,93,0,False,8,2024,False
2024-03-27,Brooklyn Nets,122,Washington Wizards,119,1,False,3,2024,False
2024-03-27,Portland Trail Blazers,106,Atlanta Hawks,120,0,True,14,2024,False
2024-03-27,Los Angeles Clippers,108,Philadelphia 76ers,107,0,False,1,2024,False
2024-03-27,New York Knicks,145,Toronto Raptors,101,0,False,44,2024,False
2024-03-27,Indiana Pacers,99,Chicago Bulls,125,0,True,26,2024,False
2024-03-27,Los Angeles Lakers,136,Memphis Grizzlies,124,0,False,12,2024,False
2024-03-27,Detroit Pistons,91,Minnesota Timberwolves,106,0,True,15,2024,False
2024-03-27,Houston Rockets,132,Oklahoma City Thunder,126,1,False,6,2024,False
2024-03-27,San Antonio Spurs,118,Utah Jazz,111,0,False,7,2024,False
2024-03-27,Phoenix Suns,104,Denver Nuggets,97,0,False,7,2024,False
2024-03-28,Boston Celtics,122,Atlanta Hawks,123,1,True,1,2024,False
2024-03-28,Milwaukee Bucks,100,New Orleans Pelicans,107,0,True,7,2024,False
2024-03-29,Golden State Warriors,115,Charlotte Hornets,97,0,False,18,2024,False
2024-03-29,Los Angeles Lakers,90,Indiana Pacers,109,0,True,19,2024,False
2024-03-29,Los Angeles Clippers,100,Orlando Magic,97,0,False,3,2024,False
2024-03-29,Detroit Pistons,96,Washington Wizards,87,0,False,9,2024,False
2024-03-29,Chicago Bulls,108,Brooklyn Nets,125,0,True,17,2024,False
2024-03-29,Philadelphia 76ers,114,Cleveland Cavaliers,117,0,True,3,2024,False
2024-03-29,Portland Trail Blazers,82,Miami Heat,142,0,True,60,2024,False
2024-03-29,Phoenix Suns,103,Oklahoma City Thunder,128,0,True,25,2024,False
2024-03-29,New York Knicks,126,San Antonio Spurs,130,1,True,4,2024,False
2024-03-29,Minnesota Timberwolves,111,Denver Nuggets,98,0,False,13,2024,False
2024-03-29,Houston Rockets,101,Utah Jazz,100,0,False,1,2024,False
2024-03-29,Dallas Mavericks,107,Sacramento Kings,103,0,False,4,2024,False
2024-03-30,Boston Celtics,104,New Orleans Pelicans,92,0,False,12,2024,False
2024-03-30,Memphis Grizzlies,88,Orlando Magic,118,0,True,30,2024,False
2024-03-30,Milwaukee Bucks,122,Atlanta Hawks,113,0,False,9,2024,False
2024-03-31,Cleveland Cavaliers,101,Denver Nuggets,130,0,True,29,2024,False
2024-03-31,Los Angeles Lakers,116,Brooklyn Nets,104,0,False,12,2024,False
2024-03-31,Los Angeles Clippers,130,Charlotte Hornets,118,0,False,12,2024,False
2024-03-31,Philadelphia 76ers,135,Toronto Raptors,120,0,False,15,2024,False
2024-03-31,Miami Heat,119,Washington Wizards,107,0,False,12,2024,False
2024-03-31,Dallas Mavericks,125,Houston Rockets,107,0,False,18,2024,False
2024-03-31,Chicago Bulls,109,Minnesota Timberwolves,101,0,False,8,2024,False
2024-03-31,Oklahoma City Thunder,113,New York Knicks,112,0,False,1,2024,False
2024-03-31,Golden State Warriors,117,San Antonio Spurs,113,0,False,4,2024,False
2024-03-31,Utah Jazz,106,Sacramento Kings,127,0,True,21,2024,False
2024-04-01,Boston Celtics,118,Charlotte Hornets,104,0,False,14,2024,False
2024-04-01,Memphis Grizzlies,110,Detroit Pistons,108,0,False,2,2024,False
2024-04-01,Brooklyn Nets,111,Indiana Pacers,133,0,True,22,2024,False
2024-04-01,Portland Trail Blazers,103,Orlando Magic,104,0,True,1,2024,False
2024-04-01,Atlanta Hawks,113,Chicago Bulls,101,0,False,12,2024,False
2024-04-01,Phoenix Suns,124,New Orleans Pelicans,111,0,False,13,2024,False
2024-04-02,Los Angeles Lakers,128,Toronto Raptors,111,0,False,17,2024,False
2024-04-02,Milwaukee Bucks,113,Washington Wizards,117,0,True,4,2024,False
2024-04-02,New York Knicks,99,Miami Heat,109,0,True,10,2024,False
2024-04-02,Oklahoma City Thunder,105,Philadelphia 76ers,109,0,True,4,2024,False
2024-04-02,Houston Rockets,106,Minnesota Timberwolves,113,0,True,7,2024,False
2024-04-02,San Antonio Spurs,105,Denver Nuggets,110,0,True,5,2024,False
2024-04-02,Cleveland Cavaliers,129,Utah Jazz,113,0,False,16,2024,False
2024-04-02,Dallas Mavericks,100,Golden State Warriors,104,0,True,4,2024,False
2024-04-02,Los Angeles Clippers,95,Sacramento Kings,109,0,True,14,2024,False
2024-04-03,Portland Trail Blazers,89,Charlotte Hornets,86,0,False,3,2024,False
2024-04-03,Los Angeles Lakers,125,Washington Wizards,120,0,False,5,2024,False
2024-04-03,Detroit Pistons,113,Atlanta Hawks,121,0,True,8,2024,False
2024-04-03,Oklahoma City Thunder,100,Boston Celtics,135,0,True,35,2024,False
2024-04-03,Indiana Pacers,111,Brooklyn Nets,115,0,True,4,2024,False
2024-04-03,Memphis Grizzlies,111,Milwaukee Bucks,101,0,False,10,2024,False
2024-04-03,Toronto Raptors,85,Minnesota Timberwolves,133,0,True,48,2024,False
2024-04-03,Orlando Magic,117,New Orleans Pelicans,108,0,False,9,2024,False
2024-04-03,Cleveland Cavaliers,101,Phoenix Suns,122,0,True,21,2024,False
2024-04-04,Atlanta Hawks,95,Dallas Mavericks,109,0,True,14,2024,False
2024-04-04,Philadelphia 76ers,109,Miami Heat,105,0,False,4,2024,False
2024-04-04,Sacramento Kings,109,New York Knicks,120,0,True,11,2024,False
2024-04-04,Golden State Warriors,133,Houston Rockets,110,0,False,23,2024,False
2024-04-04,Denver Nuggets,100,Los Angeles Clippers,102,0,True,2,2024,False
2024-04-05,Orlando Magic,115,Charlotte Hornets,124,0,True,9,2024,False
2024-04-05,Oklahoma City Thunder,112,Indiana Pacers,126,0,True,14,2024,False
2024-04-05,Portland Trail Blazers,108,Washington Wizards,102,0,False,6,2024,False
2024-04-05,Sacramento Kings,100,Boston Celtics,101,0,True,1,2024,False
2024-04-05,New York Knicks,100,Chicago Bulls,108,0,True,8,2024,False
2024-04-05,Miami Heat,119,Houston Rockets,104,0,False,15,2024,False
2024-04-05,Detroit Pistons,90,Memphis Grizzlies,108,0,True,18,2024,False
2024-04-05,Toronto Raptors,117,Milwaukee Bucks,111,0,False,6,2024,False
2024-04-05,San Antonio Spurs,111,New Orleans Pelicans,109,0,False,2,2024,False
2024-04-05,Golden State Warriors,106,Dallas Mavericks,108,0,True,2,2024,False
2024-04-05,Minnesota Timberwolves,87,Phoenix Suns,97,0,True,10,2024,False
2024-04-05,Utah Jazz,102,Los Angeles Clippers,131,0,True,29,2024,False
2024-04-06,Cleveland Cavaliers,97,Los Angeles Lakers,116,0,True,19,2024,False
2024-04-06,Detroit Pistons,103,Brooklyn Nets,113,0,True,10,2024,False
2024-04-06,Philadelphia 76ers,116,Memphis Grizzlies,96,0,False,20,2024,False
2024-04-06,Atlanta Hawks,110,Denver Nuggets,142,0,True,32,2024,False
2024-04-07,Houston Rockets,136,Dallas Mavericks,147,1,True,11,2024,False
2024-04-07,Cleveland Cavaliers,118,Los Angeles Clippers,120,0,True,2,2024,False
2024-04-07,Miami Heat,115,Indiana Pacers,117,0,True,2,2024,False
2024-04-07,Portland Trail Blazers,107,Boston Celtics,124,0,True,17,2024,False
2024-04-07,Oklahoma City Thunder,121,Charlotte Hornets,118,0,False,3,2024,False
2024-04-07,Chicago Bulls,98,Orlando Magic,113,0,True,15,2024,False
2024-04-07,New Orleans Pelicans,113,Phoenix Suns,105,0,False,8,2024,False
2024-04-07,Washington Wizards,122,Toronto Raptors,130,0,True,8,2024,False
2024-04-07,New York Knicks,122,Milwaukee Bucks,109,0,False,13,2024,False
2024-04-07,Philadelphia 76ers,133,San Antonio Spurs,126,2,False,7,2024,False
2024-04-07,Sacramento Kings,107,Brooklyn Nets,77,0,False,30,2024,False
2024-04-07,Utah Jazz,110,Golden State Warriors,118,0,True,8,2024,False
2024-04-07,Minnesota Timberwolves,127,Los Angeles Lakers,117,0,False,10,2024,False
2024-04-09,Dallas Mavericks,130,Charlotte Hornets,104,0,False,26,2024,False
2024-04-09,Detroit Pistons,102,Philadelphia 76ers,120,0,True,18,2024,False
2024-04-09,Indiana Pacers,140,Toronto Raptors,123,0,False,17,2024,False
2024-04-09,Miami Heat,117,Atlanta Hawks,111,2,False,6,2024,False
2024-04-09,Boston Celtics,91,Milwaukee Bucks,104,0,True,13,2024,False
2024-04-09,New York Knicks,128,Chicago Bulls,117,0,False,11,2024,False
2024-04-09,Orlando Magic,106,Houston Rockets,118,0,True,12,2024,False
2024-04-09,San Antonio Spurs,102,Memphis Grizzlies,87,0,False,15,2024,False
2024-04-09,Washington Wizards,121,Minnesota Timberwolves,130,0,True,9,2024,False
2024-04-09,Sacramento Kings,105,Oklahoma City Thunder,112,0,True,7,2024,False
2024-04-09,Denver Nuggets,111,Utah Jazz,95,0,False,16,2024,False
2024-04-09,Golden State Warriors,134,Los Angeles Lakers,120,0,False,14,2024,False
2024-04-09,Los Angeles Clippers,105,Phoenix Suns,92,0,False,13,2024,False
2024-04-09,New Orleans Pelicans,110,Portland Trail Blazers,100,0,False,10,2024,False
2024-04-10,Memphis Grizzlies,98,Cleveland Cavaliers,110,0,True,12,2024,False
2024-04-10,Charlotte Hornets,115,Atlanta Hawks,114,0,False,1,2024,False
2024-04-10,Toronto Raptors,102,Brooklyn Nets,106,0,True,4,2024,False
2024-04-10,Dallas Mavericks,111,Miami Heat,92,0,False,19,2024,False
2024-04-10,Orlando Magic,99,Milwaukee Bucks,117,0,True,18,2024,False
2024-04-10,San Antonio Spurs,89,Oklahoma City Thunder,127,0,True,38,2024,False
2024-04-10,Minnesota Timberwolves,107,Denver Nuggets,116,0,True,9,2024,False
2024-04-10,Phoenix Suns,124,Los Angeles Clippers,108,0,False,16,2024,False
2024-04-11,Chicago Bulls,127,Detroit Pistons,105,0,False,22,2024,False
2024-04-11,New York Knicks,118,Boston Celtics,109,0,False,9,2024,False
2024-04-11,Houston Rockets,121,Utah Jazz,124,0,True,3,2024,False
2024-04-11,Golden State Warriors,100,Portland Trail Blazers,92,0,False,8,2024,False
2024-04-11,New Orleans Pelicans,135,Sacramento Kings,123,0,False,12,2024,False
2024-04-12,Orlando Magic,113,Philadelphia 76ers,125,0,True,12,2024,False
2024-04-12,Chicago Bulls,129,Washington Wizards,127,0,False,2,2024,False
2024-04-12,Charlotte Hornets,98,Boston Celtics,131,0,True,33,2024,False
2024-04-12,Indiana Pacers,120,Cleveland Cavaliers,129,0,True,9,2024,False
2024-04-12,Brooklyn Nets,107,New York Knicks,111,0,True,4,2024,False
2024-04-12,Los Angeles Lakers,123,Memphis Grizzlies,120,0,False,3,2024,False
2024-04-12,Toronto Raptors,103,Miami Heat,125,0,True,22,2024,False
2024-04-12,Atlanta Hawks,106,Minnesota Timberwolves,109,0,True,3,2024,False
2024-04-12,Milwaukee Bucks,107,Oklahoma City Thunder,125,0,True,18,2024,False
2024-04-12,Denver Nuggets,120,San Antonio Spurs,121,0,True,1,2024,False
2024-04-12,Detroit Pistons,107,Dallas Mavericks,89,0,False,18,2024,False
2024-04-12,New Orleans Pelicans,114,Golden State Warriors,109,0,False,5,2024,False
2024-04-12,Houston Rockets,116,Portland Trail Blazers,107,0,False,9,2024,False
2024-04-12,Utah Jazz,110,Los Angeles Clippers,109,0,False,1,2024,False
2024-04-12,Phoenix Suns,108,Sacramento Kings,107,0,False,1,2024,False
2024-04-14,Washington Wizards,122,Boston Celtics,132,0,True,10,2024,False
2024-04-14,Charlotte Hornets,120,Cleveland Cavaliers,110,0,False,10,2024,False
2024-04-14,Atlanta Hawks,115,Indiana Pacers,157,0,True,42,2024,False
2024-04-14,Toronto Raptors,103,Miami Heat,118,0,True,15,2024,False
2024-04-14,Chicago Bulls,119,New York Knicks,120,1,True,1,2024,False
2024-04-14,Milwaukee Bucks,88,Orlando Magic,113,0,True,25,2024,False
2024-04-14,Brooklyn Nets,86,Philadelphia 76ers,107,0,True,21,2024,False
2024-04-14,Utah Jazz,116,Golden State Warriors,123,0,True,7,2024,False
2024-04-14,Houston Rockets,116,Los Angeles Clippers,105,0,False,11,2024,False
2024-04-14,Denver Nuggets,126,Memphis Grizzlies,111,0,False,15,2024,False
2024-04-14,Phoenix Suns,125,Minnesota Timberwolves,106,0,False,19,2024,False
2024-04-14,Los Angeles Lakers,124,New Orleans Pelicans,108,0,False,16,2024,False
2024-04-14,Dallas Mavericks,86,Oklahoma City Thunder,135,0,True,49,2024,False
2024-04-14,Portland Trail Blazers,82,Sacramento Kings,121,0,True,39,2024,False
2024-04-14,Detroit Pistons,95,San Antonio Spurs,123,0,True,28,2024,False
2024-04-16,Los Angeles Lakers,110,New Orleans Pelicans,106,0,False,4,2024,False
2024-04-16,Golden State Warriors,94,Sacramento Kings,118,0,True,24,2024,False
2024-04-17,Miami Heat,104,Philadelphia 76ers,105,0,True,1,2024,False
2024-04-17,Atlanta Hawks,116,Chicago Bulls,131,0,True,15,2024,False
2024-04-19,Chicago Bulls,91,Miami Heat,112,0,True,21,2024,False
2024-04-19,Sacramento Kings,98,New Orleans Pelicans,105,0,True,7,2024,False
2024-04-20,Orlando Magic,83,Cleveland Cavaliers,97,0,True,14,2024,True
2024-04-20,Phoenix Suns,95,Minnesota Timberwolves,120,0,True,25,2024,True
2024-04-20,Philadelphia 76ers,104,New York Knicks,111,0,True,7,2024,True
2024-04-20,Los Angeles Lakers,103,Denver Nuggets,114,0,True,11,2024,True
2024-04-21,Miami Heat,94,Boston Celtics,114,0,True,20,2024,True
2024-04-21,Dallas Mavericks,97,Los Angeles Clippers,109,0,True,12,2024,True
2024-04-21,Indiana Pacers,94,Milwaukee Bucks,109,0,True,15,2024,True
2024-04-21,New Orleans Pelicans,92,Oklahoma City Thunder,94,0,True,2,2024,True
2024-04-22,Orlando Magic,86,Cleveland Cavaliers,96,0,True,10,2024,True
2024-04-22,Philadelphia 76ers,101,New York Knicks,104,0,True,3,2024,True
2024-04-22,Los Angeles Lakers,99,Denver Nuggets,101,0,True,2,2024,True
2024-04-23,Phoenix Suns,93,Minnesota Timberwolves,105,0,True,12,2024,True
2024-04-23,Indiana Pacers,125,Milwaukee Bucks,108,0,False,17,2024,True
2024-04-23,Dallas Mavericks,96,Los Angeles Clippers,93,0,False,3,2024,True
2024-04-24,Miami Heat,111,Boston Celtics,101,0,False,10,2024,True
2024-04-24,New Orleans Pelicans,92,Oklahoma City Thunder,124,0,True,32,2024,True
2024-04-25,Cleveland Cavaliers,83,Orlando Magic,121,0,True,38,2024,True
2024-04-25,New York Knicks,114,Philadelphia 76ers,125,0,True,11,2024,True
2024-04-25,Denver Nuggets,112,Los Angeles Lakers,105,0,False,7,2024,True
2024-04-26,Milwaukee Bucks,118,Indiana Pacers,121,1,True,3,2024,True
2024-04-26,Los Angeles Clippers,90,Dallas Mavericks,101,0,True,11,2024,True
2024-04-26,Minnesota Timberwolves,126,Phoenix Suns,109,0,False,17,2024,True
2024-04-27,Cleveland Cavaliers,89,Orlando Magic,112,0,True,23,2024,True
2024-04-27,Oklahoma City Thunder,106,New Orleans Pelicans,85,0,False,21,2024,True
2024-04-27,Boston Celtics,104,Miami Heat,84,0,False,20,2024,True
2024-04-27,Denver Nuggets,108,Los Angeles Lakers,119,0,True,11,2024,True
2024-04-28,New York Knicks,97,Philadelphia 76ers,92,0,False,5,2024,True
2024-04-28,Los Angeles Clippers,116,Dallas Mavericks,111,0,False,5,2024,True
2024-04-28,Milwaukee Bucks,113,Indiana Pacers,126,0,True,13,2024,True
2024-04-28,Minnesota Timberwolves,122,Phoenix Suns,116,0,False,6,2024,True
2024-04-29,Boston Celtics,102,Miami Heat,88,0,False,14,2024,True
2024-04-29,Oklahoma City Thunder,97,New Orleans Pelicans,89,0,False,8,2024,True
2024-04-29,Los Angeles Lakers,106,Denver Nuggets,108,0,True,2,2024,True
2024-04-30,Philadelphia 76ers,112,New York Knicks,106,1,False,6,2024,True
2024-04-30,Orlando Magic,103,Cleveland Cavaliers,104,0,True,1,2024,True
2024-04-30,Indiana Pacers,92,Milwaukee Bucks,115,0,True,23,2024,True
2024-05-01,Miami Heat,84,Boston Celtics,118,0,True,34,2024,True
2024-05-01,Dallas Mavericks,123,Los Angeles Clippers,93,0,False,30,2024,True
2024-05-02,Milwaukee Bucks,98,Indiana Pacers,120,0,True,22,2024,True
2024-05-02,New York Knicks,118,Philadelphia 76ers,115,0,False,3,2024,True
2024-05-03,Cleveland Cavaliers,96,Orlando Magic,103,0,True,7,2024,True
2024-05-03,Los Angeles Clippers,101,Dallas Mavericks,114,0,True,13,2024,True
2024-05-04,Minnesota Timberwolves,106,Denver Nuggets,99,0,False,7,2024,True
2024-05-05,Orlando Magic,94,Cleveland Cavaliers,106,0,True,12,2024,True
2024-05-06,Indiana Pacers,117,New York Knicks,121,0,True,4,2024,True
2024-05-06,Minnesota Timberwolves,106,Denver Nuggets,80,0,False,26,2024,True
2024-05-07,Cleveland Cavaliers,95,Boston Celtics,120,0,True,25,2024,True
2024-05-07,Dallas Mavericks,95,Oklahoma City Thunder,117,0,True,22,2024,True
2024-05-08,Indiana Pacers,121,New York Knicks,130,0,True,9,2024,True
2024-05-09,Cleveland Cavaliers,118,Boston Celtics,94,0,False,24,2024,True
2024-05-09,Dallas Mavericks,119,Oklahoma City Thunder,110,0,False,9,2024,True
2024-05-10,New York Knicks,106,Indiana Pacers,111,0,True,5,2024,True
2024-05-10,Denver Nuggets,117,Minnesota Timberwolves,90,0,False,27,2024,True
2024-05-11,Oklahoma City Thunder,101,Dallas Mavericks,105,0,True,4,2024,True
2024-05-11,Boston Celtics,106,Cleveland Cavaliers,93,0,False,13,2024,True
2024-05-12,New York Knicks,89,Indiana Pacers,121,0,True,32,2024,True
2024-05-12,Denver Nuggets,115,Minnesota Timberwolves,107,0,False,8,2024,True
2024-05-13,Boston Celtics,109,Cleveland Cavaliers,102,0,False,7,2024,True
2024-05-13,Oklahoma City Thunder,100,Dallas Mavericks,96,0,False,4,2024,True
2024-05-14,Indiana Pacers,91,New York Knicks,121,0,True,30,2024,True
2024-05-14,Minnesota Timberwolves,97,Denver Nuggets,112,0,True,15,2024,True
2024-05-15,Cleveland Cavaliers,98,Boston Celtics,113,0,True,15,2024,True
2024-05-15,Dallas Mavericks,104,Oklahoma City Thunder,92,0,False,12,2024,True
2024-05-16,Denver Nuggets,70,Minnesota Timberwolves,115,0,True,45,2024,True
2024-05-17,New York Knicks,103,Indiana Pacers,116,0,True,13,2024,True
2024-05-18,Oklahoma City Thunder,116,Dallas Mavericks,117,0,True,1,2024,True
2024-05-19,Indiana Pacers,130,New York Knicks,109,0,False,21,2024,True
2024-05-19,Minnesota Timberwolves,98,Denver Nuggets,90,0,False,8,2024,True
2024-05-21,Indiana Pacers,128,Boston Celtics,133,1,True,5,2024,True
2024-05-22,Dallas Mavericks,108,Minnesota Timberwolves,105,0,False,3,2024,True
2024-05-23,Indiana Pacers,110,Boston Celtics,126,0,True,16,2024,True
2024-05-24,Dallas Mavericks,109,Minnesota Timberwolves,108,0,False,1,2024,True
2024-05-25,Boston Celtics,114,Indiana Pacers,111,0,False,3,2024,True
2024-05-26,Minnesota Timberwolves,107,Dallas Mavericks,116,0,True,9,2024,True
2024-05-27,Boston Celtics,105,Indiana Pacers,102,0,False,3,2024,True
2024-05-28,Minnesota Timberwolves,105,Dallas Mavericks,100,0,False,5,2024,True
2024-05-30,Dallas Mavericks,124,Minnesota Timberwolves,103,0,False,21,2024,True
2024-06-06,Dallas Mavericks,89,Boston Celtics,107,0,True,18,2024,True
2024-06-09,Dallas Mavericks,98,Boston Celtics,105,0,True,7,2024,True
2024-06-12,Boston Celtics,106,Dallas Mavericks,99,0,False,7,2024,True
2024-06-14,Boston Celtics,84,Dallas Mavericks,122,0,True,38,2024,True
2024-06-17,Dallas Mavericks,88,Boston Celtics,106,0,True,18,2024,True
